ank	अंक
anka	अंका
ankit	अंकित
anakon	अनाकों
ankhon	आंखों
ankon	अंकों
angkor	एंग्कोर
ankor	अंकोर
angaarak	अंगराक
angarak	अंगरक
angraji	अंग्रजी
angreji	अंग्रेजी
angrzi	अंग्रजी
antah	अंताह
antaha	अंताहा
antarmukh	अंतरमुख
antmurkh	अंतरूमक
antrmukh	अंतरमुख
andrabee	अंदरबी
andrabi	अंदरबी
andha	अंधा
andhapan	अंधपान
andheri	अंधरी
ambaani	अंबानी
ambani	अंबानी
akram	अक्रम
acapulco	एकापकॉल
akapulko	अकापुलकों
akhand	अखंद
akhil	आखिल
agavai	अगवाई
agvaai	अगवाई
augustine	अगस्टिएन
augustustine	अगस्स्टस्टिन
agsta	अग्सता
agusta	गग्सता
augusta	औगस्ता
agr	अग्र
agra	अग्रा
achambha	अचंभा
achanbha	अचंछा
achievement	अचिवेंटम
achivement	आचिवेंटम
acchi	अच्छी
achchi	अच्छी
achhi	अछी
achyut	अचुय्त
achhanera	अचान्चरा
achnera	अचेनरा
ajmeedh	आजमीद
ajhar	अझार
azhar	आखर
ajit	अजित
agnat	अग्नत
agyaat	अज्ञात
agyat	अज्ञात
atakta	अताकता
atkata	आत्कता
atake	अटाके
atke	एटके
atwaal	अतवाल
atwal	अतवाल
attahasa	अट्तहास
atthaas	अट्थास
atthas	अट्थस
addon	एड्डोन
athak	अठक
atharv	अथर्व
atharva	अथर्व
adad	आदाद
adaani	अदानी
adani	आदानी
advait	अदवाती
adwait	अदवाती
advaitvaad	अदवावताद
advaitwad	अदवात्ववद
adhivas	अधिवास
adhiwas	अधिवास
advivas	अदविवास
adhiik	अधिक
adhik	अधिक
adhyayanarat	अध्यायनारत
adhyayanrat	अध्यायर्नत
adhyaynrat	अध्यायर्नत
anant	अनंत
ananti	अनंती
angadh	अंगढ़
angarh	अंगर
anchahe	अंचाहे
anthak	अंथक
unthak	उन्थक
anhoni	अन्हों
anaavashyak	अनावाज्यक
anavashyak	अनवाश्यक
anavshyak	अनावश्यक
anawashyak	अनावाज्यक
anik	अनिक
anishwarvadi	अनिश्ववादी
anishwarwadi	अनिश्ववादी
anukoltha	अनुकोलता
anukulata	अनुकुलाता
anukulta	अनुकुलता
anuchit	अनुच्छित
anuprayogi	अनुप्रयागियों
anuprayogon	अनुप्रयोगों
anupryogon	अनुप्रयोगों
anureet	अनुरित
anurit	अनुरित
anuthi	अनुठि
anudit	अनुदित
anyaay	अन्याय
anyay	अन्यय
anyaya	अन्याय
apnani	अपनानी
aparivartanshali	अपरिवर्थनाली
aparivartansheel	अपरिवर्शनावील
aparivartanshil	अपरिवर्शनाविल
apariharya	अपरिहर्य
aprihary	अपरिहर्य
apriyary	अप्रियर्य
apavartit	अपवर्तित
apvartit	अपवर्तित
apvtrit	अप्वत्रित
apaardarshi	अपरदर्शी
apardarshi	अपरदर्शी
afroj	अफ़रोज
afroz	अफ़रोज
africa	अफ्रिका
abbaasi	अबबासी
abbasi	एब्बासी
abhimat	अभिमात
abhishap	अभिष्प
abhi	अभि
amjhera	अंजहरा
amzera	अजमीड़ा
amargad	अमरगद
amargarh	अमरगढ़
amarpaal	अमरपाल
amarpal	अमरपाल
amarohi	अमरोही
amrohi	अमरोही
amaanat	अमानत
amanat	अमानत
amanth	अमंत
amaanati	अमानती
amanathi	अमानाथी
amanati	अमानती
amavasya	अमवास्य
amavsya	अमावस्य
amit	अमीत
amitao	अमीताओं
amitav	अमिताव
amuk	आमुक
amogh	आमोग्ध
ambani	अंबानी
ayodhyaanaath	अयोध्यानाथ
ayodhyanaath	अय्योलानाथ
ayodhyanath	अयोध्यनाथ
ayodhyeanath	आयोध्यानाथ
aradas	अरादास
ardaas	अर्दास
ardas	अर्दस
arabab	अरबब
arbab	अरबाब
around	अरुंद
arjent	आर्जेंट
urgent	अर्जेंट
arth	आर्थ
artha	अर्थ
earth	इंर्थ
earthquake	एर्खकुके
arthon	आर्थों
arpit	आर्किट
aryama	आर्यमा
aryma	आर्यमा
arymaa	आर्यमा
alankaar	अलंकर
alankar	अलंकर
alnkaar	अलंकर
alankaaron	अलंकरों
alankaron	अलंकरों
alnkaaron	अलंकरों
alnkaron	अलंकरों
alagavavadi	अलगवावादी
algavvadi	अलग्ववादी
algavwaadi	अलग्ववादी
alive	अलीवे
alance	एलांस
alayans	एलायंस
aliance	एलाइंस
alind	अलिंद
alai	अलाई
ali	एली
alii	आलिय
alonso	एलोंस
aloso	एलोसो
alphabet	अल्भाउते
alba	अलबा
avantipur	आवंतपुरु
awantipora	आवंतेपुर
avaru	आवरू
avru	आवरू
awaru	आवारु
avarodhak	अवरोधक
avrodhak	अवरोधक
avrodhk	अवरोधक
avarnata	अवर्णता
avarnataa	अवर्णता
avranta	अवरंता
avashist	आवशिस्त
avshisht	अवशिष्ट
awashist	आवशिस्त
avasthaayen	अवस्थाएं
avsthaen	अवस्थाएं
avsthayen	अवस्थाएं
awasthaen	अवस्थाएं
avi	आवी
avika	आविका
aviral	अवेरल
avirl	एवर्ल
avishvaasniy	अविश्वासनीय
avishvasniy	अविश्वस्नीय
avishvasniya	अविश्वस्नीय
avisvasniya	अविस्वस्णीय
aviva	अविवा
avaigyanic	अवैग्यांकियां
avaigyanik	अवैग्यांकिया
avegyanik	एवेजेमिकन
ashaktataa	आश्चकता
ashktta	अष्चत्ता
asharaphi	अश्राफी
ashrafi	अश्रफी
ashariri	आशरीरी
ashriri	आश्रीरी
ashrvatath	अश्रवात्थ
ashvtth	अश्वत्थ
asamaany	असामान्य
asamany	असामान्य
asmanye	अस्मान्य
asaamnjsy	असांज्मीश
asamanjasy	असामंज्स
asamanjasya	असामंज्यस
asurakshit	असुरक्षित
asurkshit	असृक्षित
aset	एसेट
asset	एसेट
asvabhavik	अस्वाभाविक
aswabhavik	अस्वाभाविक
aswbhavik	अस्वभ्विक
ahirauli	अहिरोली
item	इत्मे
items	इत्मेस
idle	आईडीएल
idol	आईडल
icc	आईसीसी
iso	आईसी
ipc	आईपीसी
ipad	ईप
iris	आईआईसीएस
ounce	ऑनस
aakaash	आकाश
aakash	आकाश
aake	आके
aakhet	आखेत
akhet	अखेत
aagat	आगत
aagaman	आगमान
aagman	आगमन
aagaa	आगा
aagah	आगाह
agha	आघा
aagaashe	आग्शे
aagashe	आग्शे
agashe	अग्शे
aajmaanaa	आजमाना
aajmana	आजमाना
aazmaanaa	आजमाना
aata	आता
ata	अता
atta	अत्ता
aatmayen	आत्मयें
atmaen	आत्माएं
aadaan	आदान
aadan	आड़न
aadhaarit	आधारित
aadharit	आधारित
adharit	अधारित
aadheen	आधीन
aadhin	आधीन
aadhunik	आधुनिक
aanad	आंद
aanand	आनंद
anand	आनंद
aapka	आपका
aapkaa	आपका
aapadaaaen	आपदाएं
aapdaein	आपदाएं
aapdayein	आपदाएं
aabantit	आवंतित
abantit	अबंतित
aabru	आबरू
abaru	आबारू
aamdan	आमदान
amadan	अमादान
aamdani	आमदानी
amadani	अमादानी
aamdi	आमदी
amdi	अमदी
aamod	आमोद
amod	अमोद
aayenge	आएंगे
aayojak	आयोजक
ro	रो
rp	आरपी
aaraam	आराम
aaram	आराम
aram	अरम
aarushi	आरुषी
arushi	अरुषी
artery	आर्टरी
order	ऑर्डर
aary	आर्य
aarya	आर्य
arya	आर्य
aaryika	आरिकाय
aryika	अर्यिका
aarya	आर्य
arya	आर्य
aryo	आर्यो
aaryan	आर्यन
arya	आर्य
aryon	आर्यों
aalsi	एलसी
alasi	एलासी
aalochak	आलोचक
alochak	आलोचक
aalochakon	आलोचकों
alochakon	आलोचकों
aalha	आल्हा
aalhaa	आह्ला
alha	आल्हा
allah	अल्लाह
aawaazen	आवाजें
aawajen	आवाजें
awaazen	आवाजें
awazen	आवाजें
aawajon	आवाजों
aawazon	आवाजों
awaazon	आवाजों
awazon	आवाजों
aavishakaar	आविष्कार
aavishkaar	आविष्कार
avishkar	अविष्कार
aavriti	आवृति
aavritti	आवृत्ति
avuti	आवुटी
aavritiyon	आवरितायों
aavrittiyon	आवृत्तियों
avrutiyon	आवृत्यों
aashanka	आशंका
ashanka	अशंका
aashriton	आश्रितों
ashriton	अश्रितों
aasaan	आसन
aasan	आसन
asan	असन
aastik	आस्तिक
astik	अस्तिक
aasteen	आस्तिन
aastin	आस्तिन
astin	अस्तिन
aahnaan	आहनां
aahnan	आहनां
ahyan	आह्यान
england	इंगलैंड
engineer	इंजीनर
introduction	इंटर्ट्कोक्योन
insurance	इनसर्नेक
ear	ईं
eyer	आयर
eon	इयोन
iaan	ईबन
ekattha	एकट्ठा
ikattha	इक्टठा
ekatthi	इकट्ठ
ekthi	इक्थी
ikatthi	इकट्ठी
ekaee	एकाई
ikai	इकाई
ekaeyon	इकाइयों
ikaiyon	ईकाइयों
ikarion	इकरियों
economic	इकोनॉमिक
ecuador	इक्यूडर
equador	इक्डूड़र
equities	इक्विटीस
ikvitija	इकविटीज
ijaajat	इज़ाजत
ijajat	इज़ाजत
inhalation	इंखलातिओं
inhaletion	इंखलितों
ibija	इबिजा
ibiza	इबिजा
imaging	आमिजिंग
immune	इम्यून
elaichi	एलेची
ilaichi	इलाइची
ilayachi	इलायची
ilayichi	इलायीची
elaaj	इलाज
ilaaj	इलाज
ilaj	इलाज
ishaak	इशाक
ishaaq	इशाक
ishak	इशक
ishaara	इशारा
ishaaraa	इशारा
ishara	इशारा
ishita	इशिता
isht	ईश्ट
isteefe	इस्तीफे
istife	इस्टीफ
ea	ईए
ia	ईए
eater	इतर
iter	इतर
email	इमैल
emailon	इमैलों
emelon	इमलों
evening	एवेंगिंग
east	ईस्ट
ishat	इश्त
isht	ईश्ट
isaaiyon	ईसाइयों
isaiyon	ईसाइयों
isayiyon	ईसाइयों
ikhrul	इखरूल
ukhrool	उखूर्ल
ukhrul	उखूर्ल
uchhalane	उछलने
uchhalne	उछलने
ujback	उबज्क
uzbek	उज्बेक
uthane	उठाने
uthne	उठने
uthaakar	उठाकर
uthakar	उठाकर
uthaapatak	उठपातक
uthapatak	उठपातक
uthen	उठें
udaan	उदान
udan	उड़न
udaanaa	उदाना
udana	उड़ना
udaane	उड़ने
udane	उड़ने
udaanen	उडानें
udanen	उड़नें
udaanon	उदानों
udanon	उदानों
utane	उतने
utaney	उतने
utne	उतने
uttara	उत्तरा
uttra	उत्त्र
utpan	उत्पन
udant	उड़ंत
udghosh	उद्घोष
udar	उदार
uda	उड़ा
udaa	उड़ा
udakishuganj	उदाकीश्दगं
udakishunganj	उदाकिशंदांग
unatees	उनतेसी
untees	अन्टीज
uniyal	युनियल
upadraviyon	उपदारवियों
updravion	अप्दवृति
updraviyon	उपद्रवियों
upadravi	उपदरवी
updravi	उपद्रवी
upadrawon	उपदारवों
updravon	उपद्रवों
upneta	उपनेता
upabhokta	उपभूकता
upbhokta	उपभूकता
uplaksh	उपलक्ष
uplakshay	उपलक्षय
uplakshya	उपलक्षकय
uplabdh	उपलब्ध
uplabdhiyon	उपलबाधियों
uplabdhi	उपलबोधी
upakhyaanon	उपखानाओं
upakhyanon	उपख्याओं
ubuntu	उब्नूत
ubaal	उबाल
ubal	उबाल
ubhaara	उभरा
ubhara	उभरा
umanath	उमनाथ
umesh	उमेश
urf	उर्फ
urfa	उर्फा
urff	उर्फ
urvarakon	उर्वारकों
urvarkon	उर्वार्कों
urwarakon	उर्वारकों
urvarata	उर्वर्त
urvarta	उर्वर्ता
urwarta	उर्वर्ता
ulate	उलते
ulte	एल्टे
ulahana	उलहाना
ulahna	उलहना
ulema	उलेमा
ulemaon	उलेमाओं
usak	उसक
usaki	उसकी
uski	उसकी
usmein	उस्में
usmen	उस्में
usi	यूसी
ustara	उस्तरा
udharv	उधारव
udhrva	उद्धवा
urdhav	उर्धव
ushma	उष्मा
rishicool	रिशिकोल
rishikul	ऋषिकूल
rushikul	ऋषिकल
enzyme	एंजमी
anton	एंटन
entone	एंटोन
antoni	अंटोनी
antony	एंटनी
endometrial	एंडोमेशियल
andreas	एंडरिस
als	एल्स
asi	एसी
eksaath	एक्साथ
eksath	एक्साथ
ekaki	एकाकी
xm	एक्सम
egmor	एजमोर
egmore	एजमोर
aj	अज़
agende	एजेंड
adp	एडीपी
adain	आदेन
aden	एडेन
edan	एडन
addi	एडी
eddi	एडीडी
eddie	एडिडी
eddy	एडीटी
apj	ओपज
ftii	फ्टी
abbott	एबॉब्ट
abut	अबूत
ebt	एब्ट
abvp	अब्व
abbot	एब्बॉट
abbott	एबॉब्ट
mta	एमएट
mtake	माटके
mtec	मेटक
mtech	मेचेथ
emerald	एमरेल्ड
emrald	एमराल्ड
emil	एमील
emile	एमिल
emily	एमिली
amy	अमी
emi	एमी
airway	एयरवे
eyarave	एयरवे
eyarve	एयरवे
error	एररो
arica	एरिका
erica	एरिका
erika	एरिका
aerobic	एरिबिक
aerobics	एयरबिक्स
lte	लेटी
lti	लीटी
allergic	अलांजरिक
eliminator	इलिमिनातर
aliens	एलेयस
alliance	एलायंस
asian	एशियां
sfc	एसएफसी
sk	एसके
spf	एसपीपी
association	एसोसिएशन
astar	अस्तर
aster	अस्टर
ester	एस्टर
aesthetics	आस्टीटेक्स
asthetic	एश्टेटिक
asfalt	अस्फॉल्ट
asphalt	अस्फलट
asphault	अस्फभुत
ahsaas	अहसास
ehsaas	एहसास
ehsas	एहसास
aisa	एसा
eesa	ईसा
ainth	ऐंठ
end	एंड
enth	ईंठ
ainthey	ऐंठे
enthe	ईंठे
aithan	ऐंठन
ethan	इथन
ethhan	ऐंठन
ail	ऐल
el	एल
alaps	अलप्स
alps	एल्प्स
aise	एस
oxide	ऑक्सीड
oxy	ऑक्सी
offers	ऑफर्स
offshor	ओफ्शोर
offshore	ओफ्सेशर
official	ऑफिबालिया
okalahoma	ओकलाहाम
oklahoma	ओकलाहाम
oklahoma	ओकलाहाम
ot	आट
opel	ओपेल
obrayan	ओबाराएं
obrien	ऑबरीन
oran	ओरान
orian	ऑरियन
orion	ऑरियन
olavrishti	उलवृष्टि
ovum	उवम
owem	ऑपवें
oceanic	ओकसिन
osaka	ओसका
auchity	औषिटी
auchitya	औचित्य
audhyogikaran	औधियोजकरण
audyogikarana	औदोजियोर्ण
audyogikikaran	औद्योगिकेसिण
aurangabad	औरंगगभ
aurora	औरोरा
aulakh	औलाख
kankad	कांकड़
kankar	कनकर
kankad	कांकड़
kankar	कनकर
kangan	कांगन
conjunction	कंजक्शन
contemporary	कंटोमपरी
kanthahar	कंठारह
kanthhar	कंठर
composer	कॉप्रोजर
kambalon	कंबलों
kanblon	कंबलों
consultant	कंसलटेंट
kakkad	कक्कड़
kakkar	कक्कर
kacche	कच्छे
kachche	कच्चे
karta	कर्ता
katra	कतरा
cutlery	कट्लरी
katlari	कत्लारी
katlary	कात्ञाद्मी
katasaraj	कतासर्ज
kathfodave	कठ्फोड़ेव
kathfodve	कठ्फोड़ेड
kathor	कथोर
kathore	कठोरे
kanika	कनिका
kathai	कथाई
katthai	कट्थाई
katthaii	कट्थाई
convention	कंटेंशन
canals	कैनल्स
kanaal	कनाल
kanal	कनल
kanindham	कानिंधम
kaningham	कनिंघम
kanishthika	कनिष्ठिका
kanishthikaa	कनिष्ठिका
kanishtika	कनिष्टिका
kanyaayen	कन्याएं
kanyaein	कन्याएं
kanyayen	कन्याएं
convention	कंटेंशन
convocation	कन्वेशोशन
cup	कूप
kap	काप
kapda	कपदा
kpada	कपाड़ा
kapdo	कपदो
kapdon	कपड़ों
kaping	कपिंग
kping	क्पिंग
kapolkalpana	कपोलक्पणाला
kabaddi	कबाददी
kabr	कबर
kabra	कब्रा
kabren	कबरें
kabron	कबरों
kamjor	कमजोर
kamzor	कमजोर
kamatar	कमातर
kamtar	कमतर
kalamjeet	कलमाजीत
kamaljeet	कमलाजित
kamaauu	कमाऊ
kamau	कमाऊ
kamaate	कमाते
kamate	कमते
kamere	कमेरे
kmere	क्मेर
karanj	करंज
kranj	क्रंज
karanjiya	करणजीय
kardhe	कर्धे
karghe	करघे
karachana	कराचना
karchhana	कर्चना
karna	कर्ण
karpatri	कर्पत्री
karam	कर्म
karoor	करूर
karur	करूर
karnataka	कर्णताका
karvi	करवी
kurvi	कुर्वी
kalmein	कलमें
kalmen	कलमें
kalraj	कलराज
kalika	कलिका
kalpanaon	कल्पनाओं
kalpnaon	कल्पनाओं
kavvaliyon	कववालियों
qawwaliyon	कववालियों
kavvali	कववाली
qawwali	कववाली
kashton	कष्टों
kasarat	कसरत
kasrat	कसरत
kasara	कसरा
kasida	कसीदा
kahane	कहाने
kahne	कहने
kahlaya	कहलाया
kahaniyon	कहानियों
kile	किले
kanji	कंजी
cant	कैंट
kant	कांट
kanti	कंटी
kakoo	काकू
kaku	काकू
kaagaj	कागज
kaagaz	काग़ज़
kagaj	कागज
kagaz	कागज
kaaji	काजी
kaji	काजी
kazi	काजी
qazi	क़ाजी
kajoo	काजू
kaju	काजू
kapadi	कपड़ी
kapdi	कपड़ी
kamraj	कम्रज
kamottejana	कमोटेट्गाना
kamottejna	कमोटेट्गाना
kailana	कैलाना
kaylana	कायलना
carfi	कार्फी
karki	कर्की
kartik	कार्तिक
karyakartaon	कार्यकारकारों
karykartaaon	कार्यकारणाराओं
karykartaon	कार्यकारणार
karyabhar	कारभार
karybhar	कारभार
karyarat	कार्यार्त
karyrat	कार्यार्त
kaalpi	काल्पी
kalapi	कलापी
kalpi	कल्पी
kalika	कलिका
kalighat	कालीघात
coldvel	कोल्डवेल
kaldvel	कल्डवेल
kaldwell	कल्डवेल
kaav	काव
kav	कव
kaasht	काश्त
kasht	कश्ट
kasim	कसिम
qasim	कैसिम
kasimabad	कसीमाबद
kiya	किया
kiliyan	किलियां
killat	किल्लत
killi	किल्ली
kisaani	किसानी
kisani	किसनी
kisanon	किसानों
keede	कीदे
kide	किड
keynote	कीनाएट
kinote	किनोट
kiratpur	किरातपुर
kundal	कुंडल
kundaliya	कुंडालिया
kundaliyan	कुंडालियन
kutta	कुत्ता
kuposhit	कुपोषिट
kumau	कुमाऊ
kumavat	कुमावत
kumawat	कुमावत
kural	कुराल
kurmi	कुर्मी
kursiyon	कुरसियों
kush	कुश
kushaan	कुशान
kushan	कुशान
kusumalataa	कुसुमालता
kusumalta	कुसुमल्ता
kusumlata	कुजुमत्ला
koot	कूट
kut	कुट
kritika	कृतिका
kpo	कपो
canterbari	कैंट्रबीरी
canterbury	कैंट्रब्री
candidate	कैंडिडेट
katrina	कटरिना
caitlyn	कैटल
cateline	कैटेलन
catlin	कैटलीन
cadmium	कैडमियम
catholic	कैथलिक
catholicon	कैथलोकिन
kaetholikon	कैथोलिकों
capacitor	कैपेक्टर
carat	कारत
cavity	कैविटी
cavalry	कैवल्री
kaivelari	कैवेलरी
complex	कॉप्लेंस
kocchi	कोची
kochi	कोची
corridor	कॉरिडोर
corolla	कोरोला
korola	कोरोला
caolan	कोलान
colan	कोलान
colon	कोलों
calling	कॉलिंग
koling	कोलिंग
colorado	कोलोरडो
kolorado	कोलोराडो
kaushal	कौशल
kaushalata	कौशलता
kaushalta	कौशलता
kaushambi	कौशमबी
cute	कूट
quete	क्वेट
cube	कब
cubeck	कुबेक्स
quebec	क्बाबेस
cubes	कब्स
krantiyon	क्रांतियों
cric	क्रिक
crick	क्रिक
cricket	क्रिक्ट
cricketer	क्रिक्टेयर
cricketing	क्रिकाइटिंग
kriyayog	क्रियायोगी
christian	क्रिस्चियन
kruger	क्रूगर
craig	क्रैग
creg	क्रेज
cradle	क्राडल
chrom	क्रम
chrome	क्रोम
client	क्लाइंट
clock	क्लॉक
clasen	क्लासेन
classen	क्लासेन
classon	क्लासिन
clay	क्ले
claris	क्लारिस
cleris	क्रियर्स
clerys	क्रेयर्स
quantico	क्वांटोक
queens	क्वाइस
kshitij	क्षितिज
shitij	क्षीतिज
kshin	क्षिण
shin	क्षिण
kshetron	क्षेत्रों
shetron	क्षेत्रों
khand	खंड
khanda	खांडा
khachakhach	खाचचाख
khajarana	खजरना
khajraana	खजराना
khajrana	खजराना
khatakati	खताकती
khatakti	खटकती
kihatkati	किहत्तकी
khattapan	खत्तपान
khat	खात
khani	खानी
khanik	खनिक
khanikarm	खानीकर्म
khanikarma	खानीकर्म
khanikarmi	खानीकर्मी
khapat	खपत
khariya	खरिया
khalnayak	खलनायक
khaaskar	खास्कर
khaskar	खस्कर
khaastaur	खासतौर
khastaur	खस्तार
khaibar	खैबर
khyber	खैबर
khaein	खाएं
khaen	खाएं
khayen	खाएं
khaate	खाते
khaatey	खाते
khate	खाते
khal	खल
khinchakar	खिंचकर
khinchkar	खिंचकर
khilana	खिलाना
khinchkar	खिंचकर
khuda	खुड़ा
khudai	खुड़ाई
khurapka	खुरपका
khurpaka	खुरपका
khurasan	खुरासन
khushiyan	खुशियां
khene	खेने
khaini	खाईं
khairati	खैरती
khoikhoi	खोईकोई
khoya	खोया
gangrel	गंगरल
gangaajal	गंगाजल
gangajal	गंगाजल
gandaki	गंदकी
gandki	गंडकी
gandh	गंध
gandha	गंधा
gae	गाए
gaye	गाए
gajara	गजरा
gajra	गजरा
gadkar	गड़कर
ganapati	गणपति
ganpati	गणपती
gatisheel	गतीशेली
gatishil	गतिशिल
gatishilata	गतिशिलता
gadadhar	गदाधार
gammat	गम्मत
gaya	गाया
garibi	गरीबी
garjana	गरजाना
galgand	गलगांड
gahmagahmi	गहमागमही
gemhagehmi	गेहमहागीम
ganguly	गंगली
gaanth	गंत
ganth	गंत
gaanthe	गण्थे
ganthe	गण्थे
ganthen	गंथें
ganthon	गंथों
gaen	गाएं
gayen	गाएं
gazi	गाजी
gajipur	गाजीपुर
gazipur	गाजीपुर
gayatri	गयत्री
gayitri	गयित्री
gaytri	गैत्री
gidgidate	गिगाडिडात
ginate	गिनते
ginte	गिंटे
girkar	गिरकर
girijaghar	गिरिजाघर
girjaghar	गिरजाघर
girijagharon	गिरिजाघरों
girjagharon	गिरजाघरों
girati	गिरती
girti	गिरती
girish	गिरिश
guan	गुण
gujar	गुजर
gujarata	गुजराता
gujarta	गुजरता
gujarate	गुजराते
gujarte	गुजरते
gujarana	गुजराना
gujarna	गुजरना
gujara	गुजरा
gujare	गुजरे
gutta	गुत्ता
gthalidar	ग्तालिदार
guthalidar	गुतालीदार
gudna	गुड़ना
gumaan	गुमान
guman	गुमान
gulshan	गुलशान
gunga	गुंगा
grihnagar	गृहणगर
gruhnagar	गृहणगर
galaxion	गलक्सियों
galaxiyon	गलक्सियों
galaxyon	गलक्सयों
gochar	गोचार
gouchar	गुचारो
godara	गोदारा
gopichand	गोपिचंद
gomake	गोमके
gomke	गोमके
goel	गोल
goyal	गोयल
gosvaami	गोसवामी
gosvami	गोस्वामी
goswami	गोसवामी
gaumukh	गौमुख
gomukh	गोमुख
gaumutr	गौमुत्र
gaumutra	गौमुत्र
gowmutra	गोमुत्र
granthiyaan	ग्रांथियां
granthiyan	ग्रांथियां
grandhiyon	ग्रांधियों
granthiyon	ग्रांथियों
greest	ग्रीस्ट
greist	ग्रेस्ट
grist	ग्रिस्ट
greg	ग्रेज
granite	ग्रेनिट
grenite	ग्रेनेट
grandson	ग्रांडस
gross	ग्रोस
ghataatop	घटातोप
ghatatop	घटोटप
ghataayaa	घटाया
ghataya	घटाया
ghanakar	घानकर
ghabrahat	घबराहट
ghasi	घसी
ghisai	घिसाई
ghisi	घिसी
ghise	घिसे
ghumakkadi	घुमककड़ी
ghumakkdi	घुमकक्डी
ghumakkadon	घुमककड़ों
ghumakkaron	घुमक्कारों
ghumakkdon	घुमककुड़ों
ghummakkadon	घुमक्पकादों
ghumaan	घुमान
ghuman	घुमान
ghoonsa	घूंसा
ghunsa	घुंसा
ghongha	घोंघा
ghontane	घोंटने
ghontne	घोंटने
ghot	घोट
ghodi	घोड़ी
ghost	घोस्ट
changul	चांगुल
chand	चंद
chandan	चंदन
chandana	चंदना
chandu	चंदु
chandon	चंदों
chandrabali	चंद्रबाली
chandramaon	चंद्रमाओं
chakatte	चकतेते
chaktte	चकते
chakkar	चक्कर
chkkar	चककर
chakshu	चक्षु
chatagaon	चाटागाओं
chatgaon	चत्गाओं
chadhane	चढ़ने
chadhne	चढ़ने
chaturdik	चातुर्दिक
chatunshkoniy	चतुनकोशियाई
chatushkoniy	चतुकोश्यिनी
chatushkoniya	चतुकोश्यियां
channa	चन्ना
chabate	चबाते
chabutare	चबुतरे
chabutre	चब्छूरे
chamakna	चमकाना
chamkana	चमकाना
charas	चरास
charit	चारीत
charcha	चर्चा
churcha	चुर्चा
charchaon	चर्चाओं
chalenge	चलेंगे
chlenge	च्लेंग
chahunaur	चाहुनार
chahunor	चहुंोर
chanval	चंवल
chanwal	चंवल
chachaji	च्छाजी
chadar	चड़ार
chadaron	चड़ारों
chadron	चड़रों
chan	चान
chanan	चनन
chaplusi	चापलुसी
chayal	चयाल
char	चर
charon	चरों
charge	चर्ज
chart	चार्ट
charton	चर्तों
charts	चार्ट्स
chaalit	चलित
chalit	चलित
chikitsak	चिकित्सक
chikitsakon	चिकित्सकों
chikhali	चिखली
chiththi	चिथ्ती
chitthi	चित्ती
chithhi	चिथ्छी
chiththi	चिथ्ती
chitthi	चित्ती
chidchidapan	चिड़चिड़ापान
chidchidapan	चिड़चिड़ापान
chidhate	चिछड़े
chidhte	चिढ़ते
chithrkar	चित्रकर
chitrkar	चित्रकार
chipakane	चिपकाने
chipakne	चिपकने
chipkane	चिपकाने
chimati	चिमती
chimti	चिमटी
chillane	चिल्लेन
chee	ची
chi	ची
chuka	चुका
chune	छुने
chunar	चुनार
changed	चांगेड
chetti	चेत्ती
chennai	चेन्नाई
chero	चेरो
chest	चेस्ट
championship	चैंपिप्शियर
chor	कोर
choro	चोरो
choron	कोरों
chauk	चौक
chowk	चोड्क
chauka	चौका
chuka	चुका
chaukiyan	चौकियां
chauki	चौकी
chaukhate	चौखते
chauguni	चौगुनी
chauda	चौदा
chaudah	चौदह
chaudahavan	चौदहवान
chaudhavan	चौदवहान
chaudhawan	चौद्वहान
chaupati	चौपती
chupaty	चुपात्य
chaupal	चौपल
chaurai	चौराई
chausinga	चौजिंगा
chausingha	चौसिंघा
chhagan	छगान
chhabi	छाबी
chhalla	छल्ला
chhallaa	छल्ला
chhaviyaan	छावियां
chhaviyan	छावियां
chhavi	छावी
cheh	चेह
chhah	छा
chehon	चेहों
chhahon	छाहों
chhai	छाय
chhagla	छगला
chhajan	छजन
chhaati	छाती
chhati	छटी
chhaapemaar	छापापराज
chhapemar	छप्पेराम
chheenk	छींक
chhink	छिंक
chink	चिंक
chenkein	चेंकें
chhekein	छेकें
chhinke	छिंके
chhinky	छिंक्य
chinke	चिंके
chhudaane	छुड़ाने
chhudane	छुड़ने
chhupakar	छुपाकर
chhupkar	छुपकर
chhupkr	छुपकर
chhupata	छुपता
chhupta	छुपता
chhuptaa	छुपता
chhura	छुड़ा
chhuraa	छुड़ा
chhuree	छुरी
chhuri	छुरी
chhure	छुड़े
chhootane	छुटने
chhutane	छुटने
chhutne	छुटने
chheter	छेत्र
chhetr	छेत्र
chhetter	छेट्टर
chhetri	छेत्री
chhetthari	छेत्थारी
chhetthri	छेत्तरी
chai	चाय
chhai	छाय
chhe	छे
jagaega	जगाएगा
jagayega	जगाएगा
jaghaega	जगाएगा
jgaayega	जगाया
jgayegaa	जगाएगा
jajaon	जाजाओं
jajon	जाजों
jad	जड़
jadd	जड़
jaddit	जड़ित
jadeite	जादेते
jadet	जड़ेत
jadit	जादित
jadein	जादें
jaden	जादें
jatara	जतारा
jatra	जत्र
jataati	जताती
jatatee	जटाती
jatati	जटती
janagananaa	जनगनना
janaganna	जनगन्न
jangadnaa	जंगदाना
janganana	जांगनाना
janganna	जांगनना
janajagran	जनजागरण
janjaagran	जंजागरण
janjagran	जंजबर्ण
january	जनुरी
janahaani	जनहानी
janahani	जनहानी
janhaani	जनहानी
janhani	जन्हानी
jnhaani	जनहीं
jamaate	जमाते
jamaati	जमाती
jamati	जमाती
jamaaya	जमाया
jamaeya	जमाया
jamaya	जमाया
jamayaa	जमाया
jamuai	जामुई
jamuei	जमुई
jamui	जामुई
jai	जाई
jay	जाय
jaidayal	जैदयाल
jayadayal	जयादलय
jaydayal	जयादलय
jaibaan	जयबान
jaiban	जयबान
jaybaan	जायाबन
jayalalita	जायलीता
jayalalitaa	जायलीता
jayalalithaa	जयलीलताह
jaylalita	जयलालिता
jarakh	जरख
zarakh	जरख
jarda	जर्द
jardaa	जरदा
zarda	जरदा
jalagati	जलागती
jalgati	जलगती
jalgti	जलवक्ती
jalte	जलते
jalbharav	जलभरव
jalbhraav	जलभराव
jalbhrav	जलभरव
jalvaayu	जलवायु
jalvayu	जलवायु
jalesar	जलेसर
jasmeet	जस्मित
jasmit	जस्मित
jassee	जस्सी
jassi	जस्सी
jamaanaa	जमाना
jamana	जमाना
zamaanaa	ज़माना
zamana	ज़माना
jaljale	जलजले
zalzale	जलजले
zee	जी
jubaan	जुबान
juban	जुबान
zuban	जुबान
jaanch	जांच
jaaunch	जानच
janch	जांच
jaunch	जानच
jaagriti	जागरिती
jagriti	जगरीती
jagruti	जगरूती
jajamau	जजमाओ
jajmau	जजमाह
jajmauu	जजमाऊ
jaat	जाट
jat	जाट
jaatak	जातक
jatak	जटक
jaatakon	जातकों
jaatkon	जातकों
jatakon	जटकों
jaatiyon	जातियों
jatiyon	जातियों
jaankaaron	जानकारों
jaankaron	जानकरों
jankaron	जनकरों
jaanam	जानम
janam	जन्म
jaayke	जायके
jayke	जाये
jaawar	जावर
zawar	जवार
jing	जिंग
gin	गिन
jeen	जीन
jin	जीन
ginee	गिनी
jinee	जीनी
jini	जीनी
geneva	जेनेवा
jeneva	जेनेवा
jiniva	जिनिवा
gypsy	गिप्सी
jimme	जिम्मे
jiya	जिया
gic	जीईस
gr	गीरी
gm	जीएम
gsm	जजीएम
gtod	गोट्ड
gtor	ग्टर
jeetod	जीतोद
jitod	जितोद
jean	जीन
jeen	जीन
jin	जीन
jeenon	जीनों
jinon	जीनों
jeepney	जीपने
jipani	जिपानी
jeeyo	जीयो
jio	जिओ
jiyo	जियो
jeera	जीरा
jira	जिरा
jeevant	जीवंत
jivant	जीवंत
jeevan	जीवान
jeewan	जीवान
jivan	जीवन
jiwan	जीवान
jeevanshaili	जीवनशीली
jivanshaili	जीवनशीली
jeevniyaan	जीवनियां
jivaniya	जिवानिया
jivaniyaan	जीवानियां
jivaniyan	जीवानियां
jeevraaj	जीवराज
jivraj	जीवर्ज
jua	जुआ
jue	जू
juye	जूए
jutee	जुटी
juti	जुटी
judaai	जुडाई
judae	जुड़ी
judai	जुडाई
judaai	जुडाई
judai	जुडाई
junoon	जुनून
junun	जुनून
junooni	जुनूनी
jununi	जुनुनी
jubair	जुबाई
juber	ज़ूबर
zubair	जुबाई
juraab	जुराब
jurab	जुराब
julaahon	जुलाहों
julahon	जुलाहों
julmon	जुलमों
zulmon	जुलमों
jood	जूड
jud	जुड
junagadh	जुनागढ़
junagarh	जुनागढ़
junior	जुनियर
jealous	जेलूस
juloos	जुलूस
julus	जुलूस
jetha	जेथा
jenner	जेनर
generic	जेनरिक
jenrick	जेंरिक
generat	जेनरेट
generate	जनरेट
jenee	जीनी
jenni	जेन्नी
jenny	जेनी
james	जमेस
jeremy	जर्मी
gerome	जर्मो
jerome	जर्मो
jacks	जैक्स
jain	जैन
gene	गेन
jaine	जाइन
jaino	जैनों
jainon	जैनों
jerry	जेरी
jasper	जसपर
jogging	जगिंग
johnson	जोंसन
jobs	जोब्स
jockey	जोके
joki	जोकी
jokhim	जोखीम
joddta	जोड़ता
jodta	जोड़ता
jorhta	जोड़ता
jodiyon	जोड़ियों
jodo	जोडो
jaun	जौन
gyatavya	ज्ञातव्य
gyatvy	ज्ञात्त्य
gyapit	ज्यापित
jyotiba	ज्योतिबा
joint	जाइंट
jvar	ज्वर
jwar	ज्वर
jvaaron	ज्वारों
jvaron	ज्वारों
jwaron	जवारों
jewellers	ज्वैलर्स
jh	झ
jha	झा
jhalakti	झलकती
jhalkati	झलकती
jhalla	झलला
jhankana	झंकना
jhankna	झंकना
jheel	झील
jhil	झिल
jheelon	झीलों
jhilon	झिलों
jhuthala	झुठला
jhuthla	झूठला
jhuthalane	झुठलाने
jhuthlane	झुठलाने
tankaar	टंकार
tankar	टंकर
takara	टकरा
takra	टकरा
takaraon	टकराओं
takravon	टकरावों
tapakti	तपक्ति
tapkati	तपकाती
time	टाइम
timer	टाइमर
taoo	ताऊ
tau	ताऊ
tapoowo	टापूवो
tapuon	टापूओं
tapuwo	तपूव
tied	टाइड
tired	टिरेड
tyred	ट्यरड
tarch	तर्च
torch	टोर्च
tik	टीक
teap	टीप
tip	टीप
tippanikar	टिप्पणाकार
tippnikar	टिप्पणिकार
tivolee	तिवलियू
tivoli	तिवोली
teekamgarh	तीकामगह
tikamgarh	टिकामगढ़
teekon	टीकों
tikon	टीकों
two	टीवी
tension	टेंसियन
tenis	टैनिस
tennis	टेनिस
taste	टस्ते
test	टेस्ट
tasting	टस्टिंग
testing	टेस्टिंग
tainin	तैनीन
tenin	टेनिन
tanish	तनीश
tennis	टेनिस
taboo	टैबू
taiboo	तैबू
taobao	तौबा
tonic	टोनिक
tonga	टोंगा
toka	टोका
tuesday	ट्यूडेज
tuning	टूनिंग
tuberculosis	टब्राउल्सिजंस
tuberkyulosis	टुब्फेसेक्सियों
truck	ट्रूक
trangistor	ट्रांजिस्टर
tranjister	ट्रांजीस्टर
transistor	ट्रांसिस्टर
transfer	ट्रांसफर
tribunal	ट्रिबूनल
tribunal	ट्रिबूनल
trubyunal	ट्रबियल
truth	तृत
tuth	टूथ
traded	ट्रेडेड
trabal	ट्राबल
trebal	ट्रेबल
trouble	ट्राबल
traip	ट्रेप
trap	ट्रेप
trot	ट्रोट
trott	ट्रॉट
thakkar	ठककर
thakkr	ठक्कर
thaharne	ठहराने
thahrane	ठहराने
theharne	ठहराने
thikane	थिकाने
thumari	थुमरी
thumri	थूमरी
theinga	थेनेगा
thenga	थेंगा
thengaa	ठेंगा
daglas	डागलास
douglas	दोगलस
dabhara	दबहरा
dabhra	दबरा
dabhoi	द्भोही
dam	डम
dum	दुम
darate	डरते
daratey	दरते
daravani	दरवानी
darawani	दरवानी
dravani	द्रवानी
down	डाउन
daak	डाक
dak	डक
daka	डका
dabi	दबी
dabolim	दाबोलिम
dinosaur	दिनोसार
diaries	डायरियस
dit	डिट
depthiriya	देप्तिरीय
diphtheria	दिहहपतिर
de	डे
dealership	डीलर्शीप
dvc	डीएचएस
dubaana	दुबाना
dubana	दूबना
dubona	डूबाना
dulne	डूलने
doonarpur	दूनरुपर
doongarpur	दूनगरपुर
dungarpur	दंगरपुर
dungerpur	डंगरपुर
dubana	दूबना
dubna	दूबना
dangerous	डैंगारोस
daisy	दैस्य
dazy	डेजी
deji	देज़ी
deputy	डिप्टी
davidson	द्विदासों
devidson	डिवाइड्सन
davey	देवे
devi	देवी
dewey	डेवे
destination	डेस्टेनिशन
datson	दातसों
datsun	दास्तून
daddy	दड़ी
dark	डर्क
dork	डोर्क
dose	डोस
domenic	डोमेनिक
doranda	दोरांदा
dolane	दोलने
dolne	डोलने
dual	डुल
duak	दुक
duke	डूके
drame	ड्रेम
dramen	ड्रेमें
drager	ड्रेगर
dredger	ड्रेगर
dreijer	ड्रेजर
dhakaal	धकाल
dhakal	धकल
dhakkal	धक्कल
dhkal	ढकल
dhale	ढाले
dhoondh	धुंध
dhundh	धुंध
dhoondhata	ढूंधता
dhundhata	धुंधता
dhundhta	धुंधता
dhoondhi	धुंधी
dhundhi	धुंधी
tanjavur	तंजावुर
thanjavur	थंजावुर
tantr	तंत्र
tantra	तंत्र
tantrikao	तंत्रिकाओं
tantrikaon	तंत्रिकाओं
tantro	टैंट्रो
tantron	टंट्रों
tagade	तगड़े
tagde	टगड़े
tadipaar	तादीपार
tadipar	तादीपर
tani	तनी
tapan	टपन
tarafa	तर्फा
tarfa	तर्फा
tarabganj	तरबंग
taras	तारस
taraash	तराश
tarash	तर्श
tarashay	तर्शय
tarashe	तर्शे
tareeko	तरीकों
tariko	तरीको
tark	टर्क
tarkvaad	तर्कवाद
tarkvad	तर्कवाद
tarkwaad	तर्कवाद
tarko	टरको
tarkon	तरकों
talabgaar	तलबागर
talabgar	तलबागर
talbagaar	तलबागर
talbagar	तलबागर
talawe	तलावे
talve	तलवे
talawon	तलावों
talvon	तलवों
tahakhana	तहकहना
tahkhaana	टहकाना
tahkhana	तहकहना
taantaa	टांटा
tanta	टांटा
tambe	टांबे
tanbe	टंबे
taaja	ताजा
taajaa	ताजा
taaza	ताज़ा
taja	ताजा
taza	ताज़ा
tansen	टंसें
taapmaanon	तप्मानों
tapmano	टप्मोनो
tapmanon	टप्मानों
taapti	तपटी
tapti	तप्ती
tarabai	तरबाई
taseer	तसीर
tasir	तसीर
taahi	ताही
tahi	तही
tikone	टिकोने
tirupati	तिरुपति
tiwari	तिवारी
ti	टी
teer	टीर
tir	तीर
teeron	तीरों
tiron	तिरों
tirthatan	तीर्थटन
tungnath	तुनग्नध
tughlaq	तुलाक
tuglak	तुगलक
tughlakabad	तुल्लाकाब
tughlaqabad	तुल्लादाज
tuglakabad	तुगलकाबड़
tugalaki	तुगलकी
tugalki	तुगलकी
tuglaki	तुगलकी
tufail	तुफल
tejaji	तेज़ाज़ी
teji	तेज़ी
tel	टेल
telon	टेलों
to	टो
toh	टॉ
taul	तौल
tyohaar	त्योहार
tyohar	त्योहार
tyoihar	त्योहार
tyauharon	त्योहारों
tyoharon	त्योहारों
tyoiharon	ट्यूफारों
trijata	त्रिजता
trijta	त्रजीता
triya	ट्रिया
tremasik	ट्रेमेसिक
trimasik	त्रिमासिक
tse	त्से
thaki	थकी
thki	ठीकी
tharti	थर्ती
thirty	थर्टी
thane	थाने
thaanvi	थानवी
thanvi	ठनवी
theateron	ठितरों
theatron	ठ्यतरों
theaters	थिटर्स
theater	ठिटर
theatre	थिटर
theateron	ठितरों
theatron	ठ्यतरों
thitron	थित्रों
theaters	थिटर्स
theatrs	थिटर्स
thiyeters	थिटर्स
thirake	थिरेक
thirke	थार्के
thief	थाइफ
then	थें
theni	ठेनी
thailee	थाइली
thaili	थाली
thaile	थाएले
dang	डैंग
danga	डांगा
dangon	डैंगों
dampati	दम्पती
danpati	दानपति
dampatiyon	दम्पतियों
dampattiyon	दम्पत्तियों
danptiyon	दंपत्यि
dadreva	ददरवा
dadrewa	दड़रवा
damoh	दमोह
dardara	दर्दारा
dardraa	दर्द्रा
durdhara	दूर्धारा
darmiyaan	दरमियां
darmiyan	दरमियां
darjano	दर्जोणों
darjanon	दर्जनों
darp	डर्प
darra	दर्र
dalbadal	दलबादल
dalbadl	दलबद्ल
dali	दली
dastaanaa	दस्ताना
dastana	दस्ताना
dastavej	दस्तावेज
dahan	डाहन
dahal	दहाल
da	डीए
daakhil	दाखिल
dakhil	दाखिल
daakhile	दाखिले
dakhile	डखीले
daataa	दाता
data	डाटा
dadari	दादरी
daanshil	दानशील
danshil	दनशील
daabholkar	दाभोक्दाम
dabholkar	दाभोक्दाम
damale	डमले
damle	डमले
dayitv	दयित्व
dayitva	दयित्व
dayitwa	दयित्व
dayitvon	दयित्वों
dayityon	दयित्यों
darul	दरूल
daav	दाव
daaw	दाव
dav	दव
daw	डेवी
daah	डाह
dah	डह
dikhla	दिखला
dikhlaa	दिखला
dikhaaiye	दिखाई
dikhaiye	दिखाए
dikhaai	दिखाई
dikhai	दिखाई
dikhayi	दिखाई
dikhaaee	दिखाई
dikhaai	दिखाई
dikhaain	दिखाएं
dikhaee	दिखाई
dikhai	दिखाई
dikhayin	दिखाएं
dikhai	दिखाई
dikhayi	दिखाई
dikhaai	दिखाई
dikhae	दिखाई
dikhai	दिखाई
dikhayi	दिखाई
dita	डीता
ditaa	डीता
dinaank	दिनांक
dinank	दिनांक
dirham	दीरहम
dilaaye	दिलाए
dilaye	दिलाए
deewani	दीवानी
diwani	दिवानी
divy	दिव्य
divya	दिव्या
divyata	दिवायता
divya	दिव्या
deepan	दीपान
deepn	दीपन
dipan	दीपान
deepsingh	डीप्सिंग
dipsingh	डिप्सींग
deepika	दीपिका
dipika	दिपिका
deeya	दीया
diya	दिया
dukaanon	दूकानों
dukanon	दूकानों
dukke	डूक्के
dukhan	दुखन
dukhit	दुखित
dukhiyon	दुखियों
dukhon	दुखों
dubhashiyon	दुभाशियों
durgun	दुर्गुन
durghatna	दुर्घटना
durghtna	दुर्घटना
duneerti	दुनरीती
durniti	दुर्णिती
durbhiksh	दुर्भिक्ष
duvidhaaen	दुविधाएं
duvidhaayein	दुविदाएं
duvidhaen	दुविधाएं
duwaidhaayein	दुवादाएं
dune	दूने
doordarshan	दूरदर्शन
durdarshan	दूरदर्शन
dradh	द्रद
dridh	दृ्ध
dekhoge	देखोगे
denevaali	देनेवाली
denevali	देनेवाली
denewaali	देनेवाली
denewali	देनेवाली
deonar	डेयरॉन
devnaar	देवनार
devnar	देवनर
devaapur	देवापुर
devapur	देवापुर
devi	देवी
devisingh	डेविजन्घ
devisinh	डेविशन
deshkaal	देशकल
deshkal	देशकल
deshke	देशके
desai	देसाई
doge	डोगे
dvadash	द्वदाश
dwaadas	द्वादस
dvivedi	ड्विवाडी
dwivedi	ड्विवाडी
dhande	ढंडे
dhandhe	धांडे
dhndhe	ध्घेड़े
dhandhon	धांधों
dhandon	धंडों
dhakelte	धकेलते
dhkelate	ढेकलेट
dhatana	धतना
dhatna	धतना
dhankuber	धंकबूर
dhanadhany	धनाढन्य
dhandhaanya	धन्धाय्म
dhandhany	धनध्यन
dhandhanya	धन्धन्य
dhamkaataa	धमकाता
dhamkata	धमकता
dhamm	धम्म
dhamma	धम्म
dhammaa	धम्मा
dharmnath	धर्मनाथ
dharmraj	धर्मराज
dharmesh	धर्मेश
dhasmaanaa	धस्माना
dhasmana	धस्मना
dhaak	ढाक
dhak	ढक
dhaaga	धागा
dhaagaa	धागा
dhaga	धागा
dhaatuein	धातुएं
dhaatuyein	धातुएं
dhtuen	ध्तूएं
dhaarak	धारक
dharak	धरक
dhaari	धारी
dhari	धारी
dhuan	धुआं
dhunaai	धुनाई
dhunai	धुनाई
dhuriya	धुरिया
dhuriyaa	धुरिया
dhuni	धुणी
dhairyavaan	धैर्यवान
dhairyawan	धैर्यवान
dhiryavan	धिर्यवन
dhiryawaan	धिर्यवान
dhokebaaj	धोखेबाज
dhokebaaz	धोखेबाज
dhokebaj	धोखेबाज
dhokebaz	धोखेबाज
dhokhebaaj	धोखेबाज
dhokhebaj	धोखेबाज
dhona	ढोना
dhonaa	ढोना
dhoraaji	धोराजी
dhoraji	धोराजी
dhoron	धोरों
dhyeyavaadi	ध्यायवादी
dhyeywadi	ध्यावादी
dyeyvadi	द्यावीदी
dhrupad	धुरपद
drupad	द्रुपद
nandanvan	नंदाम्न
nadsa	नादसा
naksal	नक्सल
naxal	नक्सल
naksalavaad	नक्सलावाद
naksalwaad	नक्सलावाद
naksalwad	नक्सबालव
naxalvaaad	नस्कावादल
naxalwaad	नस्कावलाद
naksaliyon	नकसलियों
naxaliyon	नक्सालियों
naksali	नकसली
naxali	नक्साली
nagaada	नगादा
nagaadaa	नगादा
nagaaraa	नगारा
nageene	नगीने
nagine	नगीने
najarandaaj	नजरअंदाज
najarandaaz	नजरअंदाज
nazarandaaj	नजरअंदाज
nazarandaaz	नजरअंदाज
nazarandaz	नजरअंदाज
najraane	नजराने
nazraane	नज़राने
najariyon	नज़रियों
najriyon	नज़रियों
najron	नज़रों
najeeb	नजीब
najib	नाजीब
najibabaad	नजीबाबाद
najibabad	नजीबाबद
najeem	नजीम
najim	नजीम
nazeem	नजीम
nana	नाना
nanaa	नाना
nna	नन
nanhe	नंहे
nanhein	नंहेन
nabj	नंब
nabja	नब्जा
nabz	नंब
namkeen	नमकीन
namkin	नमकीन
narnaari	नर्नारी
narnari	नर्नरी
narbhakshi	नरभक्षी
naram	नराम
narm	नर्म
narmi	नर्मी
narsanhar	नरसानहर
narsanharon	नरसानहरों
november	नवर्बर
navketan	नवकेतन
navjaagaran	नवजगरन
navjagran	नवजगर्न
navdha	नवाधा
navvadhoo	नववाधु
navvadhu	नववादु
nava	नवा
navaa	नवा
navate	नवाते
navanagar	नवानगर
nawanagar	नवानगर
navya	नवय
naseem	नसीम
nasim	नसीम
nights	नाइट्स
nitrous	नाइट्रूस
nineteez	नितेंजी
nineties	नाइटिस
ninties	निंटीस
nau	नाउ
nauu	नौ
naakaam	नाकाम
nakam	नकम
naagrik	नागरिक
nagarik	नगरिक
nagrik	नगरिक
nagin	नागिन
nadep	नडेप
nanak	नानक
nanavati	ननवती
napane	नापने
napne	नापने
napa	नापा
naam	नाम
naamdhari	नामधारी
namdhari	नंधारी
namankano	नमांकनों
namankanon	नमांकनों
namavaliyon	नमवलियों
naamo	नामो
namo	नमो
nayak	नायक
naraji	नराजी
naraingarh	नारिंगढ़
narayangadh	नारायंगढ़
narayangarh	नारायंग्रह
naasar	नासर
nahargadh	नहरगढ़
nahargarh	नहरगढ़
nikalegi	निकालेगी
nikalogi	निकालोगी
nikaalani	निकालनी
nikaalni	निकालनी
nikalani	निकलानी
nikalni	निकलनी
nicki	निकी
nicky	निकी
niki	निकी
niketan	निकेतन
nikhar	निखर
nikhari	निखरी
nigar	निगर
nigger	नाइगर
nichala	निचला
nichalaa	निचला
nichla	निचला
nitiyon	नितियों
nitya	नित्य
nityaa	नित्य
nidhaan	निधान
nidhan	निधान
nipatara	निपटरा
niptaara	निपटारा
niptaaraa	निपटारा
niptara	निपटारा
niyanta	नियंता
niyantaa	नियंता
niya	निया
niyaa	निया
nirdeshika	निर्देशिका
nirdeshikaa	निर्देशिका
nirdhaarit	निर्धारित
nirdharit	निर्धारित
nirbaadh	निर्बाध
nirbadh	निर्भद
niveshakartaa	निवेशक्रका
niveshkarta	निवेशक्रक
niveshkartaa	निविशक्रक
nischal	निश्चल
nishchal	निष्चल
nishnaat	निशानत
nishpaap	निष्पप
nihalaani	निहालानी
nihlaani	निहालनी
nihlani	निहालनी
nihaalchand	निहलचंद
nihalchand	निहलचंद
neechaaee	नीचाई
nichaai	निचाई
neat	नीत
neet	नीत
neetiyon	नीतियों
nitiyon	नितियों
neelagaay	नीलागाय
nilgai	निलगाई
neelaabh	नीलाभ
nilaabh	निलाभ
nilabh	निलाभ
nuskhe	नुस्चे
noon	नून
nun	नन
noobiyaa	नुबिया
nubiya	नुबिया
nrityashaili	नृत्यसाली
nrutyashaili	नृत्याशील
nrityon	नृत्यों
nrutyon	नृत्यों
neco	नीको
neko	नेको
nectar	नेक्टर
neg	नेग
nega	नेगा
networking	नेटवर्जिंग
neto	नेटो
neta	नेता
nemo	नेमो
nelsan	नेल्सन
nelson	नेल्सन
nations	नेटियंस
nehara	नेहरा
nehra	नेहरा
naino	नैनो
nano	ननो
naivedh	नाईवाद
naivegh	नवेंग
nevedya	नेवेद्य
nominate	नॉमिनेट
naukari	नौकरी
naukri	नौकरी
nokari	नोकरी
nokri	नकरी
notes	नोट्स
nora	नोरा
nori	नोरी
nauner	नौनर
nauvahan	नौवहन
naushad	नौशद
panchaang	पंचांग
panchang	पंचांग
punchang	पंचांग
punjab	पंजाब
punjabiyon	पंजबियों
pantar	पंतर
panter	पैंटर
punter	पंटर
pakaayein	पकाएं
pakaayen	पकाएं
pakaen	पकाएं
pakayen	पकाएं
pakaude	पकौदे
pakshapat	पक्षपात
pakshpaat	पक्षपात
pakshpat	पक्षपत
pagabadha	पगभाड़ा
pagbadha	पग्बद्ह
pagalaa	पगला
pagla	पगला
pachaataa	पचाता
pachata	पचाता
patakkar	पातककर
patkathaayein	पटक्थाएं
patkathaein	पटकथाएं
patkathayen	पटकथाएं
patki	पाटकी
pataraani	पटरानी
patrani	पत्रानी
patavaari	पटवारी
patwari	पतवारी
pataakshep	पटाक्षेप
patachep	पैचेपेश
patakshep	पटक्षेप
patiya	पटिया
patiyaa	पटिया
padaraunaa	पदारौना
padrauna	पदराहाना
padega	पड़ेगा
padegaa	पड़ेगा
padha	पढ़ा
padhaa	पढ़ा
padhaataa	पढ़ता
padhata	पढ़ता
patili	पतीली
padamawati	पदमावती
padmavati	पद्मावती
padmawati	पद्मावती
padadhikari	पदाधिकारी
panapnaa	पनपाना
panpana	पनपना
panaamaa	पनामा
panama	पनमा
paneer	पनीर
pammi	पमीमी
pammu	पमुम
pummi	पंपी
pummy	पंमी
pardesiyon	पर्देशियों
pardesi	पर्देसी
parva	पर्व
parvaa	परवा
parwa	परवा
parwaa	परवा
paraadheen	पराधीन
paraadhin	पराधीन
paradheen	पराधीन
paradhin	पराधीन
parikalpit	परिकलपित
parimal	परिमल
parishad	परिशाद
parishadiy	परिशादीय
parishadiya	परिशादिया
parishadon	परिशादों
parikhaen	परीखाएं
parikshaayein	परीक्षाएं
parikshaen	परीक्षाएं
parosane	परोसने
parosne	परोसने
parda	परदा
pardaa	परदा
purple	पर्पल
palatne	पलातने
paltane	पलटने
palaari	पलारी
palari	पलारी
pale	पाले
palmonari	पल्मानोरी
pulmonary	पल्लोमियर
plus	प्लूस
pulse	पल्स
pashtun	पशुत्न
pashtuun	पश्तुओं
pahan	पहन
pehan	पहन
pahantaa	पहनता
pahnata	पहनता
pehnate	पहनाते
pahanate	पहनते
pahante	पहनते
pehnate	पहनाते
pahnaakar	पहनाकर
pahnakar	पहनकर
pehnakar	पहनाकर
pahnaati	पहनाती
pahnati	पहनती
pehnati	पहनाती
pahani	पहनी
pahni	पहनी
pehni	पहनी
pahno	पहनो
pehno	पहनों
pahla	पहला
pahlaa	पहला
pehla	पहला
paheliyaan	पहलीयां
paheliyan	पहालेयन
paheliyon	पहलीयों
pide	पाइड
pied	पीड
pythagoras	प्थोगारस
pythogaras	प्थोगारस
paakhandi	पाखंडी
pakhandi	पखंडी
paathshaalaayein	पाठशालाएं
pathshalayein	पथाशलाएं
pathshalayen	पथशल्येस
paathyakram	पाठयक्रम
pathyakram	पाठयक्रम
pathykram	पाठयक्रम
paathyakramon	पाठ्यक्रमों
pathyakramon	पाठयक्रमोर
pathykramon	पाठ्यक्रमों
population	पोपूलेशन
pailot	पेलोट
pilot	पिलोट
pailoton	पैलोटों
piloton	पिलोटों
paarampariktaa	परमपर्किता
paramparikata	परंपरिकता
paramparikta	परंपराक्तिया
parnel	परनेल
parnell	पर्नेल
parleron	पार्लरों
parloron	पार्लोरों
parlouron	पार्लरों
paarshad	पारशाद
parshad	पारशाद
paarshadon	पारशादों
parshadon	पर्शदों
parshdon	पर्शदों
policy	पॉलिकी
pinta	पिंटा
pintaa	पिंता
piega	पीगा
piyegaa	पियागा
pic	पीस
pick	पिक
pik	पीक
piki	पीकी
piky	पिक्य
picture	पिक्चर
pigmentation	पिजमेश्टनन
pigs	पिज्स
pichde	पिछड़े
pichhade	पिछड़े
pijja	पिजजा
pizza	पिज़्ज़ा
pitaamaha	पितामाह
pitamah	पितामाह
pipra	पिप्र
pipraa	पिपरा
pipli	पिपली
pearson	पीर्सन
pierson	पियर्सन
peary	पीरी
piyari	पियारी
pisaai	पिसाई
pisai	पिसाई
pihaani	पीहानी
pihani	पिहानी
pib	पीब
pr	पीआर
pml	पमीएल
pmo	प्मू
pmch	पम्च
psv	पीएसवी
peaking	पीकिंग
picking	पिकिंग
peetne	पीटने
pitne	पीटने
pedia	पेडिया
pidiya	पीड़िया
pidiyaa	पीड़िया
peelepan	पीलेपन
pilepan	पालिपान
pv	पीवी
pisa	पीसा
putla	पुटला
putlaa	पुटला
putaliyaan	पुटालियां
putliyan	पुटलियन
putaliyon	पुटालियों
putliyon	पुटलियों
putali	पुताली
putli	पुतली
putale	पुताले
putle	पुतले
putin	पुटीन
putul	पुटुल
punargathan	पुनर्गथान
puna	पुना
puraane	पुराने
purane	पूराने
puru	पुरु
purjon	पुर्जों
purzon	पुर्जों
pulam	पलुम
pushkin	पुष्किन
pushkarana	पुषकर्न
pushkarna	पुषकर्न
pushkarnaa	पुषकर्न
pushp	पुष्प
pushpa	पुष्पा
pushpa	पुष्पा
pushpaa	पुष्पा
pushpit	पुश्पित
pushpon	पुष्पों
poonjikaran	पूंजीकरण
punjikaran	पंजीकरण
poojaapaath	पूजापाथ
poojapath	पूजाप्थ
pujapath	पूजापतः
pooranpur	पूरंपपुर
puranpur	पुरानपुर
purvaabhaas	पूर्वाभास
purvaabhas	पूर्वाभास
purvabhaas	पूर्वाभास
purvabhas	पूर्वाभास
pendulam	पेंडुलम
pendulum	पेंडुलम
peg	पेग
pages	पेजेस
pajej	पजेज
pace	पेस
pes	पेस
pastry	पास्ट्री
pangolin	पांगलों
pengolin	पेंगलिन
packard	पैकर्ड
package	पकसे
packageon	पकासेगें
packagon	पाकागों
packajon	पकासों
paim	पैम
pam	पाम
paratrooper	परतरुपर
peratrupers	पैराटर्पर्स
paranormal	परोनमांड
peranormal	परैनोमांड
paraffin	परफें
parafin	परफीन
perafin	परफें
parabola	पराबलो
perabola	पैराबाला
polimer	पॉलिमर
polymer	पोलियर
polishing	पॉलिशिंग
pokar	पोकर
poker	पॉकर
polish	पोलिश
poshit	पोशित
posta	पोस्टा
pau	पाऊ
pyade	प्याड़े
prakriya	प्रक्रिया
prakshepak	प्रक्षेपक
pratigya	प्रतिज्य
prtigyaa	प्रतिज्या
pratibhutiyan	प्रतिभूतियां
pratiyon	प्रतियों
prativaad	प्रतिवाद
prativad	प्रतिवाद
prativadi	प्रतिवादी
pratishat	प्रतिषात
praneet	प्राणीत
pranit	प्रणित
prapaat	प्रपात
prapat	प्रपत
prapaaton	प्रपातों
prapaton	प्रपतों
prabodhini	प्रबोधिनी
prayaasrat	प्रयास्तर
prayasarat	प्रयासर्त
pradarshan	प्रदर्शन
prardashan	प्रदर्शन
pravati	प्रवाती
pravatti	प्रवत्ति
prashaasanik	प्रशासनिक
prashasanik	प्रशासनिक
prashasnik	प्रशंसिक
prashaasanon	प्रशासनों
prashansanon	प्रशंसनों
prashasanon	प्रशासनों
prashikshu	प्रशिक्षु
prastaavon	प्रस्तावों
prastavon	प्रस्तवों
prahlaad	प्रहलाद
prahlad	प्रहलद
prahasan	प्रहासन
prahsan	प्रहसन
prahaarak	प्रहारक
praharak	प्रहारक
prahad	प्रहाद
prahlad	प्रहलद
privacy	प्रिवक्सी
praakkathan	प्रकाखात
prakkathan	प्रककथान
praan	प्रण
pran	प्रण
pranon	प्रणों
prathamik	प्राथमिक
prathmik	प्राथमिक
praathmikata	प्राथमिकता
prathmikta	प्राथमिकता
prathmiki	प्राथमिकी
pradhyapakon	प्राध्यापकों
prapt	प्राप्त
prapta	प्रपता
prapti	प्रापती
praroop	प्ररूप
prarup	प्ररूप
priyamani	प्रियामणी
proof	प्रूफ
pruf	प्रुफ
prekshakon	प्रेक्षकों
prem	प्रीम
premlata	प्रेमलता
prema	प्रेमा
premi	प्रेमी
profit	प्रोफिट
processing	प्रोसेसिंग
programers	प्रोग्रार्स
programmers	प्रोग्रामर्स
programs	प्रोग्राज्म
proto	प्रोटो
propellant	प्रोफेलांट
propellent	प्रोफेलेंट
praudh	प्रौढ़
proud	प्राउड
plan	प्लैन
plane	प्लाने
fund	फंड
funda	फंडा
funding	फंडिंग
fandon	फांडों
fagua	फगु
fatane	फटने
phatane	फटने
phatne	फटने
fadfadata	फड़फदता
phadphadata	फड़फदाता
fatehgadh	फटेशाग्ध
fatehgarh	फटेहागर
fabti	फाबती
phabti	फाबती
farse	फर्स
pharase	फर्स
pharse	फर्स
farheen	फर्हीं
farhin	फरहीन
farth	फर्थ
ferth	फेर्थ
pharth	फर्थ
farmion	फरमियन
fermion	फरमियों
firmian	फार्मियन
farookhabad	फरुकाभाद
farrukhabad	फर्कुभाद
farukhabad	फरुक्भाद
farookhnagar	फरूकनंदर
farrukhnagar	फर्णुक्धरन
farukhnagar	फरुकनहरान
falata	फलता
falta	फलता
phalata	फलता
falne	फलने
phalne	फलने
falitarth	फलितर्थ
phalitartha	फलितर्था
falibhoot	फल़ीभूत
falibhut	फल़ीभूत
phalibhoot	फल़ीभूत
favvara	फववारा
fawaara	फवारा
favvare	फववरे
fawaare	फवारे
favvaron	फववारों
fawaaron	फवारों
faisala	फैसला
faisla	फैसला
follow	फोलो
faansi	फांसी
fansi	फैंसी
fatama	फतमा
fatma	फात्मा
faaf	फाफ
phaaph	फाफ
farsi	फर्सी
forcee	फोर्सी
farm	फर्म
form	फोर्म
farmic	फर्मिक
formic	फोरमिक
formulae	फॉर्मुल
formule	फॉर्मुल
formuley	फर्मुल
pharmacy	फर्मासी
pharma	फर्म
pharmon	फरमों
farms	फर्म्स
finger	फिंगर
fikra	फिक्र
physician	फिजिकियन
firti	फिर्ती
fisla	फिसला
fislaa	फिसला
feeder	फीडर
fulaaye	फुलाये
fulae	फूला
fulay	फुला
furti	फुर्ती
phurti	फुर्ति
fus	फूस
phoos	फस
phus	फस
feka	फेका
fefada	फेफड़ा
fefda	फेफडा
facial	फेसियल
fact	फैक्ट
federal	फेडरल
failkar	फैलकर
failaaiye	फैलाई
failaea	फैलाए
failaiya	फैलायाय
failaiye	फैलाई
failegi	फैलेगी
font	फोंट
fogat	फोगत
phogat	फोगत
fod	फोड
phod	फोड
foda	फोडा
fodaa	फोड़ा
phoda	फोडा
fode	फोड
phode	फोड़े
fodo	फोडो
fodon	फोड़ों
phodo	फोडो
fortis	फॉर्टिस
fusion	फुशियन
fuji	फूजी
fyuji	फ्यूजी
francisca	फ्रांसिस्क
franciska	फ्रांसिक्स
fransiska	फ्रांसिका
francisco	फ्रैंसिस्को
francisko	फ्रांसिक्सो
fransisko	फ्रांसिस्को
fringe	फ्राइंग
friendship	फ्रेंडिश्प
frost	फ्रॉस्ट
flin	फ्लिन
flynn	फ्लिन
flesh	फ्लेश
bang	बैंग
bung	बुंग
bangbandhu	बंगबंधु
bangbhang	बंगभंग
bangash	बंगास
bangsh	बंग्ष
bantane	बांटने
bantne	बंटने
bandhati	बंधती
bandhti	बंधती
bandhan	बंधन
bandhuon	बंधूओं
bamba	बांबा
mumba	मुंबा
bakaayon	बकायों
bakayon	बकायों
bakaul	बकोल
bakoul	बकुल
baksa	बकसा
baksi	बक्सी
bakse	बकसे
bakhshane	बखशने
bakhshne	बखशने
bagad	बागड़
bagd	बाग्ड
bageechi	बगीची
bagichi	बगिची
bachat	बचात
bachati	बचाती
bachti	बचती
bajana	बजना
bajrangi	बाजरंगी
bajaj	बजाज
batalvi	बतलवी
badhachadhakar	बाधधकशार
badata	बदता
badhaataa	बढ़ाता
badhata	बढ़ता
badhaati	बढ़ाती
badhati	बढ़ती
badhayi	बाधायी
badhav	बाधव
badhotari	बढ़ोतरी
badhotri	बढ़ोत्री
batlaae	बतला
batlaaye	बतलाये
batlae	बतला
batlaye	बतलाई
batlaakar	बतलाकर
batlakar	बतलाकर
badlapur	बदलापुर
badali	बदली
badli	बादली
badam	बदाम
banva	बनवा
banvaa	बनवा
banaam	बनाम
banam	बनाम
bnaam	बनाम
baniya	बनिया
banu	बानु
barpaayaa	बर्पाया
barpaya	बर्पया
barsa	बरसा
barsaata	बरसाता
barsaataa	बरसाता
barsata	बरसता
barhad	बरहाद
baraat	बरात
barat	बारत
braat	ब्राट
baraamad	बरामद
baramad	बरमाद
bramad	ब्रमाद
baramade	बरामदे
baramde	बर्मेड
bare	बारे
birth	बीर्थ
baljeet	बालजीत
baljit	बालजीत
ballabh	बल्लभ
balla	बल्ला
balli	बल्ली
basava	बसवा
bastiyon	बस्तियों
bahroopiya	बहरूपिया
bahrupiya	बहरूपिय
bahamaas	बहमास
bahamas	बहमास
bahaav	बहव
bahav	बहव
bhav	भाव
bahavalpur	बहावलपुरु
bahawalpur	बहावलपुरु
bahuchara	बहुचरा
banthia	बनठीया
banthiya	बांठीय
bandhate	बंधाते
bandhte	बंधते
banbi	बंबी
bombi	बंबी
bounceron	बाउंसरों
bowling	बालिंग
baku	बकू
bakuu	बकु
baag	बाग
bag	बग
bagh	बाघ
bagabani	बगाबानी
bagbani	बगबानी
bagali	बगली
bagli	बगली
baagiyon	बागियों
bagiyon	बगियों
baago	बागो
bago	बागो
baji	बाजी
bazi	बाजी
bajaru	बजरू
bazaru	बाजरू
bajuon	बाजूओं
badh	बाढ़
badha	बढ़ा
baadhaaon	बाधाओं
baadhaon	बाधाओं
badhaaon	बढ़ाओं
badhaon	बाधाओं
baadhit	बाधित
badhit	बढ़ित
baani	बानी
bani	बनी
baapa	बापा
baapaa	बापा
bapa	बापा
bapaa	बापा
baabat	बाबत
babat	बाबत
babt	बब्त
bayern	बेयर्न
byrun	ब्यरून
barah	बरह
baarahamaasee	बारहमासी
barahamasi	बरहामसी
barahmasi	बरहमसी
barahsinga	बरास्निग्य
barasingha	बरसिंघा
bala	बला
baalti	बालती
balti	बलती
balty	बल्टी
baldvin	बालवाड़ी
baldwin	बालवाड़ी
bavaji	बावाजी
bavji	बावजी
baawaraa	बावरा
bavra	बावरा
bawara	बावरा
baahulya	बहुल्य
bahuly	बहुल्य
bahulya	बहुल्य
box	बोक्स
bikherati	बिखेरती
bikherti	बिखेर्ती
biggest	बिग्सेट
bichhua	बिछुआ
bichhuaa	बिछुआ
biji	बीजी
busy	बसे
buzy	बजी
bipin	बिपिन
bilae	बिलाए
bilai	बिलाई
billa	बिल्ला
billaa	बिल्ला
bilhaur	बिलहौर
bisva	बिसवा
biswa	बीसवा
bag	बग
bikaner	बीकानर
bikaneri	बीकानरी
bk	बीके
beejak	बीज़क
bijak	बेज़क
beef	बीफ
beem	बीम
bim	बीम
beemon	बीमों
bimon	बीमों
beerganj	बीरगंज
birganj	बिरगंज
beesavaan	बीसवां
bisavan	बीसवां
bisawan	बीसवां
beast	बेस्ट
budvig	बुड्विज
budwig	बुद्विग
bull	बुल
bulaao	बुलाओ
bulao	बुलाओ
bule	बुले
bulletin	बुलेटिन
brijesh	ब्रिजेश
benvar	बेंवर
benwar	बेंवर
beaulad	बीआल्ड
bekaaboo	बेकबो
bekabu	बेकबू
bechakar	बेचकर
bechkar	बेचकर
bechate	बेचते
bechte	बेचते
bediyan	बेड़ियां
bethanal	बेथनाल
bethnal	बेथनाल
benis	बेनिस
belacha	बेलचा
belcha	बेलचा
belinda	बेलेंदा
bevkufana	बेवकूफना
bewakoofaanaa	बेवकूपाना
bewkufana	बेवुकूलान
besahaaraa	बेशरा
besahara	बेशरा
basin	बसिन
besin	बेसिन
basil	बेसिल
besil	बेसिल
bandage	बंदगे
bandej	बंदेज़
baithantey	बैठनते
baithate	बैठते
baitool	बैटुल
baitul	बैटल
betul	बेटुल
baini	बैनी
beni	बेनी
bairakpur	बैरकपुर
barrackpore	बरक्पोर्कर
baila	बैला
bella	बेल्ला
ballistic	बलिस्तिक
bells	बेल्स
bostan	बोस्टन
bosten	बोस्टन
boston	बस्टन
bokaro	बोकरो
bodara	बोदारा
bodra	बोड़ारा
bodraa	बोदरा
bona	बोना
borkar	बोरकर
borivali	बोरिवली
boriwali	बोरिवली
born	बॉर्न
bolane	बोलाने
boliae	बोलिया
boliy	बोली
boliye	बोलीय
bosaan	बोसान
bosan	बोसन
bauni	बौनी
bouni	बौनी
byaawa	ब्यावा
byavar	ब्यावर
brajesh	ब्रजेश
brijesh	ब्रिजेश
brahmalin	ब्रह्मालीन
brahmleen	ब्रह्मलीन
brahmlin	ब्रह्मलीन
bravo	ब्रवो
brigatn	बृगटन
brighton	ब्रिटन
brigton	ब्रिग्टन
brigadier	ब्रिगाइडर
britain	बृतें
breed	ब्रीड
brock	ब्रॉक
brok	ब्रोक
broke	ब्रोक
brocken	ब्रॉकन
broken	ब्रोकें
blosam	ब्लोसम
blossom	ब्लोस्म
bhagaane	भगाने
bhagane	भगाने
bhadakaaya	भड़काय
bhadakaya	भड़काय
bhadkaayaa	भड़काय
bhadkaya	भड़काय
bharakaaya	भारकाया
bharakaya	भारकाया
bhabhoot	भभूत
bhabhut	भभुत
bhay	भाय
bhaya	भाया
bhayo	भयो
bharatanatyam	भारतनात्मिय
bharatnatyam	भारतनात्यम
bhartnatyam	भरत्नात्मय
bharate	भरते
bharte	भरते
bharani	भरनी
bharni	भरणी
bharane	भरने
bharne	भरने
bhara	भरा
bhavishya	भविष्य
bhaate	भाते
bhate	भाते
bhanu	भानु
bhabar	भाबर
bhareeye	भरीए
bhariy	भरीय
bhavanaon	भवनाओं
bhavnaon	भावनाओं
bhaskar	भस्कर
bheed	भीड़
bheera	भीरा
bhira	भीरा
bheesham	भीक्रम
bhisham	भिश्म
bhishm	भिष्प
bhugat	भुगत
bhugata	भुगता
bhugta	भुगता
bhutto	भूत्तों
bhumi	भूमी
bhurbhura	भूरभूरा
bhookh	भूख
bhukh	भूख
bhookhi	भूखी
bhukhi	भूखी
bhoogol	भूगोल
bhugol	भुगोल
bhootal	भूतल
bhutal	भूताल
bhoopsingh	भूपसिंह
bhupsingh	भुपसिंह
bhumi	भूमी
bhumika	भूमिका
bhulata	भुलाता
bhulataa	भुलता
bhulta	भुलता
bhula	भुला
bhulaa	भुला
bhooli	भूली
bhuli	भुली
bhulo	भुलो
bhulon	भूलों
bhusi	भूसी
bhooswaami	भूसवामी
bhusvami	भूसवेमी
bhuswami	भूसवामी
bhengapan	भेंगपान
bhairavnath	भैरवनाथ
bhairo	भैरो
bhogatey	भोगते
bhogte	भोगते
bhola	भोला
bholi	भोली
bholu	भोलू
bhaunho	भाऊंहों
bhaunhon	भौंहों
bhoonhon	भूंहों
bhraant	भ्रांत
bhrant	भ्रांत
brant	ब्रांट
bhraanti	भ्रांती
bhranti	भ्रांती
branti	ब्रांती
bhraantiyan	भ्राणतियां
bhrantiyan	भ्राण्तियां
bhraantiyon	भ्राणतियों
bhrantiyon	भ्रणतियों
mangesh	मंगेश
manch	मांच
manchit	मंचित
mancheeye	मानचीए
manchiy	मंचीय
manchiya	मंचिया
manchon	मैंचों
manjil	मंजील
manzil	मंजिल
manjila	मंजीला
manzila	मंजीला
manjilein	मंजीलें
manjilen	मंजीलें
manzilein	मंजीलें
manto	मानतो
mantriyon	मांत्रियों
makrani	मकरानी
maksad	मकसद
makhdumpur	मखडुमपुर
machaaye	मचाए
machae	मचाई
machaye	मचाए
machaanon	मचानों
machanno	मचनानों
machano	मचानों
machanon	मचानों
madaura	मड़ौरा
madhuara	माधुरा
madhura	माधुरा
manipal	मनिपाल
matpatron	मत्पत्रों
matthe	मट्ठे
matsyavatar	मत्स्यवास्त्र
matsyavtar	मत्स्यवत्र
masyendranath	मस्येंध्रनाथ
matsyendranath	मत्सियंद्रांथ
madhupur	मधुपुर
manmarji	मनमर्जी
manae	मनाए
manaye	मनाये
mnaey	मान्य
mam	माम
mum	मुम
maryokar	मार्यकार
mayorka	मयोसका
mayorkaa	मयोसका
mardaani	मरदानी
mardani	मरदानी
marmar	मरमर
murmur	मुरमुर
maratha	मरता
marathi	माराती
marji	मर्जी
mardanagi	मर्दागनी
mardangi	मर्दांगी
mardo	मर्दो
mardon	मर्दों
maryaadaa	मर्यादा
maryada	मर्यदा
maryaadaaon	मर्यादाओं
maryadaon	मर्यादाओं
malaga	मलगा
malaar	मलार
malar	मालर
mashrak	माष्क्र
masaaledaar	मसलादार
masaledaar	मसलेदार
masaledar	मसलेदार
masoor	मसौर
masur	मसूर
masse	मस्से
mahakane	महकाने
mahakne	महाकने
mahkane	महकाने
mehkane	महकाने
mahalon	महालों
mahlon	महलों
mahagranth	महागार्ण
mhagranth	महागर्थंह
mahajan	महजान
mhajan	महजान
mahathir	महातहीर
mhathir	महातीर
mahanatam	महानत्म
mahantam	महंत्म
mhantam	महानत्म
mahanideshak	महानिदेशक
mahanirdeshak	महानरिदेष्क
mhanideshak	महंदीशेंत
mahapauron	महापारुओं
mhapauron	महापौरों
mahapran	महाप्रण
mhapran	महाप्रण
mahamantr	महामंत्र
mahamantra	महामंत्र
mhamantra	महामंत्र
maharaja	महाराजा
mahavigyan	महाविज्ञान
mhavidyan	महाविद्यान
mahavidya	महाविद्य
mhavidya	महाविद्य
mahavishnu	महविष्णु
mahasingh	महासिंघ
mahasinh	महासिन
mahipal	महिपल
mahin	महिन
mahinon	महिनों
maang	मांग
mang	मंग
mangani	मंगानी
mangni	मंगनी
maanga	मंगा
manga	मंगा
maangi	मांगी
mangi	मंगी
maange	मांगे
mange	मांगे
mango	मंगों
maori	मारि
maajin	माजिन
majin	माजिन
mathe	माठे
mathey	माठे
maap	माप
map	मैप
mop	मोप
mamooli	ममूली
mamuli	ममुली
mame	मेम
maarvaad	मारवाड़
marvad	मारवाड़
marwar	मारवर
maariya	मारिया
mariya	मारिया
maariyo	मारियों
mario	मैरियो
mariyo	मारियो
martha	मर्था
maalish	मालीश
malish	मलीश
mave	मेव
mavey	मेवे
maas	मास
mas	मैस
mass	मैस
maason	मासों
mason	मसों
mitaao	मिटाओ
mitao	मिटाओ
mithaai	मिठाई
mithai	मिठाई
media	मेडिया
mithila	मिथिला
mithilanchal	मिलिचल्छ
mithya	मिथय
mimicry	माइमिस्री
milkiyat	मिलिकायत
misha	मिशा
mungeri	मंगरी
mundva	मूंडवा
mundwa	मूंडवा
munshiganj	मुनीशगज्न
mukarte	मुकर्ते
mukartey	मुकर्ते
mukhopadhyaya	मुखोपधिया
mukhyopadhyaay	मुखप्योधयाय
mukhyamantri	मुख्यमंत्री
munaf	मुनाफ
munafa	मुनाफा
munnu	मुन्नू
mufalisi	मुफलिसी
muflisi	मुलबिसी
mubarakpur	मुबंकपुर
mubarkpur	मुबंकपुर
murjha	मुरझा
multae	मुलता
multai	मुल्ताई
mushahid	मुशहिद
muhavare	मुहावरे
muhavre	मुहावरे
mooth	मूठ
muth	मूठ
mood	मूद
mud	मुड़
moodi	मूदी
moody	मूड़ी
mool	मूल
mul	मुल
moolchand	मूलचंद
mulchand	मुलचंद
moolar	मूलर
mular	मूलर
muller	म्यूलर
moolon	मूलों
mulon	मूलों
maxico	मैक्सिको
mexico	मैक्सिको
mega	मेगा
megapixal	मेग्पाकिमल
megapixel	मैगाप्सीकल्स
mejbaan	मेजबान
mejban	मेजबान
mezbaan	मेजबान
mejabani	मेजबानी
mejbaani	मेजबानी
mejbani	मेजबानी
mezabani	मेजबानी
mejbaan	मेजबान
mejban	मेजबान
mezbaan	मेजबान
mejbaani	मेजबानी
mejbani	मेजबानी
mezbaani	मेजबानी
mate	मैट
met	एट्ट
mates	मैट्स
medical	मेडिकल
methanol	मेथलों
menu	मेनू
mem	मेम
melaghaat	मेलाघात
melghat	मेलघाट
melaanin	मेलानिन
melanin	मेलानिन
melaani	मेलानी
melani	मेलानी
maheman	महेमान
mehamaan	मेहमान
mehaman	मेहमान
mehmaan	मेहमान
mehman	मेहमान
meharaam	मेहराम
mehram	मेहराम
macbook	मैक्बूक
matix	मैटिक्स
matrix	मैट्रिक्स
mad	माद
made	मेड
maid	मैड
maddy	मैड्डी
maidi	मैदी
main	मैं
man	मन
men	में
mainan	मैनन
menon	मेनों
manner	मनरें
maina	माइना
maine	माइन
marrej	मर्जेज
marriage	मरीज
merraige	मरेसे
maisachusets	मैशाचासेट्स
massachusetts	मैसेच्शूट्स्स
maisor	मैसर
maisore	मैसोर
mysore	मैसर
mod	मोड़
mode	मोड़े
modern	मॉडर्न
module	मुडल
modules	मॉकुलेज
modyuls	मोजल्सिम
mauritious	मॉरीशूस
mauritius	मॉरीशिस
mogali	मोगली
mowgli	मोग्ली
motive	मोटीव
mol	मॉल
mold	मोल्ड
moshe	मोशे
mosad	मोसद
mohana	मोहना
mohani	मोहानी
mohini	मोहिनी
mohim	मोहिम
maukon	मौकों
mauma	मौमा
maurya	मौर्य
morya	मोरया
maurya	मौर्य
mauryon	मौर्यों
moryon	मोरियों
maulaviyon	मौलवायियों
maulvidon	मालविदों
maulviyon	मौलवियों
maule	मौले
mauley	मौले
mausa	मौसा
yatn	याटन
yatna	यातना
yada	यादा
yda	यड़ा
yaduvansh	यदुवंश
yaduwansh	यदुवंश
jerusalem	जरअसलम
yarooshaleim	यरुशालम
yarushalem	यरुशलाम
yashpaal	यश्पल
yashpal	यश्पल
yaatna	यात्न
yatna	यातना
yaatanaon	याटनाओं
yatnaon	यातनाओं
yarayan	यारायन
yatraein	यात्राएं
yatraen	यात्रें
yaariyan	यारियां
yariyan	यरियां
yaari	यारी
yari	यारी
yugam	युगम
yugm	युग्म
yuddhrat	युद्धारत
yudhrat	युद्धार्त
ukrainian	यूक्रेनियन
ukranian	उक्राणियन
jerusalem	जरअसलम
yorker	योरकेर
yojanaein	योजनाएं
yojanaen	योजनाएं
yojanaye	योजनाय
rangate	रंगते
rangte	रंगते
rangkata	रंगकता
ranjkatha	रंजकथा
ranjkta	रंजकता
raees	रायस
rais	रैस
raktaabh	रक्तभ
raktabh	रक्तभ
rakhna	रखना
raghupati	रघुपती
raghuram	रघुमार
registerd	रिजिस्टर्ड
registered	रेजिस्टेर्ड
ratanpur	रतनपुर
runners	रनर्स
rayan	रायन
ryan	रायन
ralhan	रालहन
ravish	रवीश
ravael	रवाल
ravel	रवेल
rawail	रवाल
rasad	रसद
rasaayanik	रसायाणिक
rasaayanika	रसायनिका
rasayanika	रसायनिका
rasyanik	रस्यानिक
rasaayanon	रसायनों
rasayanon	रसायनों
rahamat	रहमत
rahmat	रहमत
rhamat	रहमत
rahenge	रहेंगे
rahegi	रहेगी
rounder	राउंडर
raak	राक
rak	रक
raakhe	राखे
rakhe	रखे
raagon	रागों
ragon	रगों
raghavan	रघवान
raaj	राज़
raj	रज
rajkot	राजकोत
rajtantra	राजतंत्र
raajneetikaran	राजनीतकारण
rajneetikaran	राजनीतकारण
rajnitikaran	राजनीतिकारण
rajma	रजमा
rajman	राजमान
raajasva	राजस्व
rajasva	राजस्व
raaji	राजी
raji	राजी
rajinaama	राजीनामा
rajinama	राजीन्म
raajon	राजों
rajon	रजों
rana	राना
raatrichar	रातरिचार
ratrichar	रात्रिचार
raadhe	राधे
radhe	रादे
ranapur	रानपुर
rabin	राबिन
robin	रोबिन
rabha	राभा
ramkot	रामकोट
ramkote	रामकोत
ramtek	रामतेक
rampur	रामपुर
rambharose	रामभरोस
rambharosey	रामभर्सिय
ramraj	रामराज
raalod	रालोद
ralaud	रालौद
ralod	रालोद
ravaley	रवाले
ravle	रावल
rasayanik	रसायनिक
racreation	रायक्रेशन
recreation	रिक्रेशन
rig	रिज
riggs	रिग्स
rigs	रिज्स
richual	रिचुल
ritual	रिटूल
reduction	रेडाक्शन
ripan	रिपान
ripon	रिपों
ria	राइया
riya	रिया
rishte	रिश्ते
rishtey	रिश्ते
risane	रिसने
risaney	रिसाने
risne	रिसने
rihana	रिहाना
rihanna	रिहनाना
regal	रेगल
rigal	रिगल
reasonal	रिएजनल
regional	रिजोनल
retreate	रेट्रीट
retweet	रेतवीत
reeta	रीता
rita	रिता
rukate	रुकते
rukte	रुकते
ruktey	रुकते
rugan	रुगान
rugna	रुग्न
ruganta	रुगंता
rugnata	रूग्नता
rojvelt	रोजलवेट
roojwelt	रूजवेल्ट
roosevelt	रूजवेल्ट
rodolph	रोडोल्फ
rudolf	रूडोल्फ
rudolph	रूडोल्फ
roopesh	रुपेश
rupesh	रुपेश
ruby	रूबी
roomani	रूमानी
rumani	रूमानी
rukavaton	रुकावटों
root	रूट
route	रूट
rooting	रूटिंग
routine	रोटिन
routing	राउटिंग
roots	रुट्स
routes	राउट्स
roopak	रुपक
rupak	रुपक
roopi	रुपी
rupi	रुपी
rantle	रंतले
rental	रेनतल
registan	रेजिस्टन
registani	रेजिस्टेन
reja	रेजा
reza	रेजा
rate	राते
rate	राते
ret	रेट
refaeli	रेफली
refeli	रेफेली
reshe	रेशे
reshey	रेशे
race	रेस
rese	रेसे
racer	रेसर
recer	रिसर
racing	रेसिंग
reson	रेसन
rehaana	रहाना
rehana	रहाना
racketeer	राकेटर
racketier	रेकेटियर
rectare	रेक्टर
radical	रेडिकल
raidical	रैडिकल
raith	रैठ
rapping	रापिंड
wrapping	रापिप्ग
robertsan	रॉबर्टन्स
robertson	रॉबर्टन्स
robinson	रॉबिन्सन
royals	रोल्स
rojlin	रोजलीन
rozlyn	रोजलीन
rotation	रोटेशन
rodrigo	रोड़रिगो
ronaldo	रोनलडो
ronit	रोनित
roni	रोनी
ropane	रोपणे
ropaney	रोपणे
ropne	रोपने
robin	रोबिन
roya	रोया
rollers	रॉलर्स
rovan	रोवन
rowan	रोवान
rosario	रोसरियो
rosariyo	रोजरियों
raubadaar	रौबादर
raubadar	रौबदार
raubdar	रौबदर
landara	लंडारा
langada	लंगड़ा
langda	लंगड़ा
langar	लांगर
langaron	लंगरों
langron	लंग्रों
lambi	लंबी
lakeer	लकीर
lakir	लकीर
lakiron	लकीरों
lakme	लक्मे
lakshmidhar	लक्ष्मीदारह
lakshmighar	लक्ष्मीघार
lakshy	लक्ष्य
lakshya	लक्ष्य
lakshyon	लक्ष्यों
lux	लुक्स
laksar	लक्सर
luxor	लक्सर
lakhkhi	लखखी
lagna	लगना
laganewale	लगनेवाले
lagnevaaley	लगनेवाले
lagnewale	लगनेवाले
lagega	लगेगा
lajjalu	लज्बलो
latkate	लटकते
ladki	लड़की
ladate	लड़ते
ladte	लड़ते
ladaai	लड़ाई
ladai	लादाई
ladaaiyon	लड़ायों
ladaeyon	लड़ायों
ladaiyon	लादायियों
lapetane	लपेटने
lapetne	लपेटन
labada	लाबदा
lbada	लबाडा
labdh	लाबद
lbdh	लल्ड
lalak	लालक
lalkarata	लालकर्ता
lalkarta	लालकर्ता
lalla	लल्ला
lavasa	लवसा
lovasa	लोवासा
lassi	लासी
lahanaa	लहना
lahna	लहना
lehna	लहना
lahraee	लहराई
lahrai	लहराई
lehrayi	लहरायी
lahalhati	लहलहटी
lahlahaati	लहलाहटी
lahlahati	लहलहाती
lahsun	लहसून
lasoon	लासून
lanchar	लंचर
launcher	लूचर्च
lycopene	लिपेकन
lime	लाइम
lives	लाइव्स
live	लाइव
laegi	लागी
lagataar	लगातार
lagatar	लगातर
laata	लाता
lata	लता
laati	लाती
lati	लाती
layega	लायेगा
lalpur	लालपुर
las	लएस
last	लास्ट
lindbhed	लिंडबेड
lingbhed	लिंब्डेल
lindan	लिंडन
lindn	लिंडन
lindon	लाइंडों
likhakar	लिखाकर
likhkar	लिखकर
ligar	लाइगर
liger	लाइगर
liberation	लाइबरेशन
libration	लाइब्रेशन
liberation	लाइबरेशन
libration	लाइब्रेशन
leaderon	लीडरों
leedaron	लीदरों
lidaron	लाड़रों
liidaron	लिडारों
louis	लुई
luis	लुई
ludhakate	लुढ़कते
ludhkate	लुढ़कते
lurhakate	लुढ़कते
lutf	लुट
lumding	लुम्डिंग
lootmaar	लूटमार
lootmar	लूटमर
landal	लंडल
lendal	लेंडल
lega	लेगा
legaa	लेगा
letakar	लेटकर
letkar	लेटकर
lenevali	लेनेवाली
lenewali	लेनेवाली
label	लबेल
labeling	लबेलिंग
labelling	लबेलिंग
labelo	लबेलों
labelon	लबेलों
lebalon	लेबलों
lemon	लेमों
laingadan	लांगदान
langdon	लंगड़ों
lengdan	लेंगड़न
laigikata	लागीकाता
laingikta	लांगिकता
lanset	लंसेट
lenset	लेंसट
lairi	लारी
lairy	लेरी
larry	लारी
lace	लेस
less	लेस
locket	लॉक्ट
laundry	लाउंड्री
longewal	लंगावेल
longewala	लंगेवाला
longoval	लंगोवल
log	लग
loge	लग
lochdar	लोचड़ार
lodi	लोडी
laurence	लारेंस
laurens	लारेंस
laurense	लारेंस
wonder	बंडर
vansh	बंश
vanshdhar	बंषधर
vanshavad	बंशावाद
vanshvaad	बंश्वद
vanshvad	बंश्वद
wanshwad	बांशवाड़
vajood	बाजूद
vajud	बजुद
wajood	बादू
vadali	बड़ली
vadli	बादली
wadali	बालाी
vanita	बनिता
vareinye	बैरेनी
varenya	बरेन्य
varn	बरन
varna	बरना
varnit	बरनीत
vartamaan	बरत्मान
vartaman	बरत्मान
vartmaan	बरत्मान
vartman	बरत्मान
varddhaman	अर्द्धजम
vardhmaan	अर्धमाना
vardhman	अर्धमान
verbal	बेरबल
varshan	बर्शन
vasharan	षशरन
vershan	बेरशन
version	बेस्रियन
varsaache	ब्रसाचे
varsaryache	ब्रसर्याची
vasearche	बासरेच
valkan	बालकान
valkkan	लालककण
velkan	लेलकन
vash	बश
vashikaran	षशीकरण
vaangchuk	बांगचुक
vangchuk	बंग्चक
wangchuk	बंगचुक
want	बैटी
vije	बिजे
vise	बाइस
wise	बाइस
vatar	बतर
water	बतर
watson	अत्सों
wattson	अत्स्त्सों
vaan	बान
waan	बान
vaanon	बानों
vanon	बानों
wanon	बानों
vatanukulan	बटनुकुनाल
watanukoollan	अतंतुलखन
vaadak	बाड़क
vadak	बड़क
vaadiyon	बादियों
vadiyon	भदियों
wadiyon	भदियों
vayana	बयाना
vayna	बायना
wayna	याना
wireless	ब्रीलेस
wirerless	रार्अअअअअगेंस
warrior	बैरियर
warriors	ब्रियर्स
valve	बालवे
wolv	बुल्व
vastavik	बस्तवाकी
vastvik	बास्तविक
vaahikayen	हाहिकाएं
vahikayen	हिचाएंसे
wahikayan	भाइकायन
winter	ब्नीटर
vincent	बिंसेंट
vikalpon	यिकालोपों
wicket	यिक्ट
vikramjeet	इक्यर्जमीत
vikramjit	इक्राम्जित
vichaarakon	बिचारकों
vicharakon	बिचारकों
vigyan	यिग्यान
vigyaani	बिग्यानी
vigyani	यिग्यानी
vigyaanon	यिग्यानों
vigyanon	यिग्यानों
vitthal	बिथल
viththal	बिथनाल
vitthal	बिथल
vitark	इतर्क
vidhaaein	बिढ़ाएं
vidyaayein	यिद्वाएं
vidyaen	यिड़ाएं
vidhaaon	बिढ़ाओं
vidyaaon	इद्यावाओं
vidyaon	यिद्याओं
vidhansabhaein	बिदंशाबाएं
vidhansabhaen	बिदंशाबान
vidhivat	यिधिवात
vidhut	यिधुत
vinasht	बिणश्त
vineet	बानीत
vinit	बिनिट
vipreetataa	बिप्रीतता
vipritata	बिप्रितता
vipra	बिप्र
vipro	बिप्रो
wipro	यप्रो
vibha	बीभा
vibhajak	बिभाजक
vibhram	बिब्राम
vibhrm	बिभर्म
vibram	बिब्राम
vimarsh	बीमार्श
vimarsho	बिमार्षो
vimarshon	बीमार्शों
virajati	बृजाती
virechan	बृशान
virodh	्रीरोध
virodhabhasi	बीरोभादशी
virodhabhason	बीरोभादशों
vividh	यिविध
vivekahin	बिवाइकन
vivekheen	बीवाखीं
visheshan	यिशेशन
visheshanon	यिशेशेंशन
visheshaadhikaar	यिशशेधाकारि
visheshadhikar	यिश्षेधकासी
vishwasaniy	यिश्वासनीय
vishwasniiya	बिश्वरानियाई
vishwasaniyata	बिश्वसंतियां
vishwasniiyataa	बिश्वस्नियाई
vishahin	बिशाहीं
vishhin	बिश्हिन
vishanu	यिशानु
vishnu	यिशुन
vlc	बीएलसी
weeks	बीक्स
veerchand	यीर्चंद
virchand	यर्चंद
veeresh	बीरेश
viresh	बीरेश
vritton	तृत्तों
vruton	र्रुटों
vrutton	उर्त्तून
venkataraman	इंतकर्मांत्र
venkatraman	इंतकर्माण
ved	एडे
wade	बड़े
wed	एडेड
wedding	बेडिंग
vediyon	एड़ियों
vedon	बेडों
venezuela	बेनजीला
veronica	बेरोनिका
veronika	बेरोनिका
weronika	बरोनिका
velvet	बेलवेट
welwet	बेलवेट
welder	बेड्डर
weldor	बेलडोर
welding	बेल्डिंग
wealth	बेल्थ
vellur	बेल्यर
velur	बेलर
vesh	बेश
wasting	एट्सिंग
westing	येस्टिंग
wastinghouse	बस्णोगेशुय
westinghouse	बेस्टोनिश्ज
vaisley	बैसले
vesle	बेसले
wesle	बेसले
vaigyaanik	बैग्मायिक
vaigyanik	बैग्मायिक्न
vegyanik	बेग्यमिक
vaigyaanikta	बैग्मायितका
vaigyanikata	बैग्मीयकता
vaigyanikta	बैग्मायितका
vaitravati	बैत्रवाति
vaitrawati	बैत्रवाति
vaimanasy	बायनामस्य
vaimanasya	बायनामस्य
vaimanya	बायनम्ञा
very	बेरी
vaisaakh	बैसाख
vaishakh	भैशक
vaishaakhi	बैशाखी
vaishakhi	बैशाखी
vaishnodevi	बैनोंतेबे
vyaktigat	ब्याट्यकुग्त
vyagr	ब्यागर
vyagra	ब्याग्र
vyatit	ब्यातित
vytit	अत्यित
vyabhichar	ब्यभिचार
vyabhichari	ब्यभिचिर
vyavadhan	ब्वाधान
vyavdhan	ब्यावधान
vyavahargat	ब्याववर्च
vyvhargat	ब्वार्वदा
vyaghat	य्याघाट
vyapak	ब्यापक
vlad	ब्लाद
wlaad	बालाद
vladimir	ब्लादीवरी
shanghai	क्षंघाई
shatpath	क्षत्थ
shanivar	क्षानिवार
shaniwar	क्षानिवार
shabana	क्षाएं
shbana	क्षबाना
shabdarth	क्षदार्थ
shamadan	क्षमादन
shmadan	क्षमाद
shamitabh	क्षिनाभूत
shamil	क्षमिल
shmil	क्षमिल
sharabon	क्राबों
shrabon	क्रभों
shararat	क्षारात
shrart	क्रर्त
sharmana	क्षमाना
shaharwasiyon	क्चवराबासियों
shahrvasiyon	क्चवराबिसियों
shervasiyon	क्षेवरासियों
shahdara	क्चाधारा
shaantikaal	क्षतानिकार
shantikal	क्षतिकल
shaao	क्शाओ
shao	क्षाओ
shaakir	क्षाकर
shakir	क्षाकर
shaakhaaen	क्षाकाएं
shakhayan	क्षायकां
shakhayen	क्षाएटाए
shayak	क्षायक
shaavakon	क्षावाकों
shavakon	क्षावकों
shavkon	क्षावकों
shaasaka	क्षसाक
shasak	क्षस
sasakon	कसाकों
shaasakon	क्षसाकों
shasakon	क्षसाकों
shipra	क्षिप्र
shirke	क्षिर्क
sheershakon	क्षेस्रकों
shirshakon	क्षिस्रकों
shirshkon	क्षिस्रकों
shujaat	क्षुजात
shujat	क्षुजत
shooting	क्षूटिंग
shutting	क्षुटिंग
should	क्षूल
shud	क्षुड़
shubhankar	क्षभुकरण
shumaali	क्षुमाली
shumali	क्षुलामी
shringaar	क्षणागर
shringar	क्षाणराग
shrungar	क्रशूराग
sheling	क्चेलिंग
shelling	क्चेलिंग
shaili	क्षाली
shaly	क्षली
sheli	क्षेली
shaishav	क्षैश्व
sean	केसन
shaun	क्षाओं
shawn	क्षाव
short	क्षोर्ट
sure	क्रूर
shrankhala	क्रश्नाल्का
shrankhalaa	क्षण्थकाल
shrunkhla	क्रशुल्का
shrankhalaaon	क्षण्पादाकाओं
shrinkhalaon	क्षण्लाधाओं
shrunkhlaon	क्षश्नोलार
shravani	क्षवानी
shrikar	क्षातिरा
shrikhand	क्षापिंदक
shrimati	क्षमति
shriram	क्रेर्म
sriram	क्रिरम
shrotaon	क्षोत्रों
shat	क्षत
sankhyaein	क्षंहाएं
sankhyaen	क्षंखाएं
sankhyayen	क्षंयाएं
sanghanit	न्शगंति
sanghnit	क्षणींत
sanchayan	क्साचनय
sanchar	क्षांचर
sanchaari	क्नशाचरी
sanchari	क्षांचरी
sanchalanon	क्षचालनों
sanchalnon	क्षेंचलों
sanjay	नजांय
sanjeevan	क्सींबाव
sanjivan	क्सांबिवां
santati	कंसताई
sandarbh	नसदंभ
sandarbha	नसंदभा
sandrbh	नसंदभ
sandarbhon	नसदंबों
sandrbhon	कसंदभों
sandali	नसंडी
sandli	नसंडी
sandhan	कंशान
samprati	क्समप्रती
samprti	क्समप्रित
samprabhu	क्संपबूरी
samprbhu	कंसप्रभू
samprabhuta	क्समब्रुहात
samprbhuta	क्यमंभपूरा
sambit	कंबित
sambhalane	क्जबहलने
sambhalne	कंबलने
sambhrant	क्ंबर्ंत
sanbharnt	क्यभर्ंत
sanyog	क्यागों
sanyukt	क्यांसुत्क
sanyukta	य्यांकुत्य
sanyukta	य्यांकुत्य
sanyogvash	क्सांभास्व
sanyojan	क्योंजन
sanyojanon	क्योगनयों
sanyojnon	क्यागनोजों
samvedikaran	क्सवेरेदानास
sanvedikaran	क्सवेरेदिकार
samshayon	क्समशयों
sanshayon	क्षणास्यों
sanshyon	क्षंश्यों
sanskaar	क्संकर
sanskar	क्संकर
sanskaari	क्संकारी
sanskari	क्सांकरी
sanskrit	क्सांस्तिर
sanskurt	क्ससुंकर
sanskritiyan	क्सांस्तिरियों
sanskrutiyan	क्ससंक्रियों
sanskritiyon	क्सांस्तिरियों
sanskrutiyon	क्ससंक्रियों
sanasthit	नसंशित
sansthit	क्संतिष्ट
sanasthita	नसंतियत
sansthita	न्सस्छिता
sakara	कसारा
sakra	कसारा
sakshan	क्षकान
suction	क्सुशन
sacchidanand	क्सेचिदांद
sachhidanand	क्शेचिदांत
sachidanand	केशिदांदन
sajja	कज्जा
sat	कस
satpal	क्सपल
satluj	क्सतुलज
sataane	कसाते
satane	कसाने
sate	कसे
satti	क्सती
satvat	क्सवत्त
sadanand	क्सांदां
sapane	कसपन
sapne	क्सपने
sapney	क्समी
saparivaar	क्सपूरावार
sapariwar	क्सापीरावर
sparivar	क्षाप्रियार
sapaat	क्सपत
sapat	क्सपत
sapate	क्सपते
sapatey	क्सपते
saptakranti	क्पस्तांक्रिती
saptkraanti	क्पस्तांक्रिती
saptapadi	क्षपतापिद
saptpadi	क्षप्तादि
saptari	क्षपत्री
sapramaan	क्षप्राम
sapraman	क्षप्राम
submit	क्सूम्टी
sabmission	क्बाबिसियों
submission	क्सूब्मिसन
sabhaein	कबाहीं
sabhaen	कबाहें
sabhayen	कबाभें
sabhen	कबहें
sabhasadon	कबशादों
sabhyata	क्यभाता
samjhoonga	क्जमूगगा
samjhunga	क्जमुग्घन
samjhungaa	क्जमुगझाना
saman	क्समन
samanvayaka	असमामावकय
samanwayaka	असमामत्या
samnvyak	अस्मंव्यक
samaadhaan	क्समधान
samadhan	क्सामधान
samadhiyon	क्सामहिकों
samadjiyon	क्समद्यजीयों
samalakha	क्समलाका
samalakhaa	क्समलाका
samahaar	क्समहार
samahar	क्समहार
samitiyan	क्मेसियान
sametati	क्मेस्तित
sametti	क्मेस्टि
sarka	क्रसका
sarkaa	क्रसका
sarkarein	क्रसरेन
sarkaren	क्रसरें
sarkaaron	क्रसकरों
sarkaron	क्रस्करों
sargana	क्रसंगा
sarganaon	क्रसंगाओं
sargi	कसरी
sarguja	क्रसुगा
sarjuga	क्रजुगा
sarsa	यससा
sarsaa	क्रसा
sarahind	क्राशिवाद
sarhind	करहिंद
sirhind	किरिंद
saraaha	क्राहा
saraha	क्राहा
saraahi	असराही
sarahi	क्राही
salaahkar	क्गालचर
salahkaar	क्लाशाकर
salahkar	क्गालचर
saleeb	क़िबली
salib	क़ेबल
select	केलेक्ट
saltanat	क्लतानत
saltnat	क्लतंत
savaal	कवाल
saval	कवाल
sawaal	कवाग
sawal	कवाल
sahakalaakar	क्चालकाकार
sahakalakar	क्चालककर
sahkalakar	क्षलकाकर
sahadev	क्शावड़
sahdev	क्शदेव
sahrawat	क्षवरत
sherawat	केशवर
sahooliyata	क्षौलियता
sahuliyat	क्षौलियत
sahuuliyata	क्षौलिवाता
saanketika	क्सेनेकिता
sanketik	क्सेंकित
saimans	यैमैंस
simmons	इंमाइंस
symons	क्योमिंस
saima	यैसामा
sagarika	जसराइका
sagrika	एससरिका
saga	एसागा
saajan	क्साजन
sajan	क्जासन
saajsajja	क्साजमाज
sajsajja	क्साजाज्ज
saja	कजा
saathsaath	क्षताश
sathsath	क्षत्त
sathiya	क्षतिया
saabah	कसाह
sabah	कबाह
samanjasy	क्समाजस्य
samanjasya	क्मांसामय
samoa	क्समो
samoaa	क्समो
saayn	कसय
sayan	कसाएं
saym	कैसे
saira	यसारा
sayara	क्यारा
sayra	क्यरा
salve	क्गावे
sahab	क्शब
singapore	किंगापार
singaar	किंगर
singar	किंगर
singer	क्साइगर
singhaadey	निग्घादे
singhade	निग्देश
singhde	निगंडे
singhre	किंग्र
singhi	किंघी
singha	किश्ञा
sinha	क्षिना
siera	क्यूराए
sierra	क्यूरर
sikud	क्सिकड़
signals	किज्नल्स
cigaretton	किराजेटन
cigretton	क्रिस्टेट
siddhivat	किद्विताद
siddhvat	यिद्वात्त
siddhwat	यिद्वात
sinabang	किसांबल
synapse	क्षामेस
sipah	क्षाप
sipaha	क्षेपा
sipahiyon	किषालियों
sipahi	किपाही
sim	एसआईएम
simat	क्मीत
simatataa	य्मेतता
simatta	य्मैट्ट
simtata	क्मीत्ता
simtataa	क्मीतता
cement	केमेंट
simate	कइमते
simi	इमी
simmy	कैमी
sims	एसमीस
siyasi	क्यासी
siyah	कियाह
siyaha	किषाई
sirpur	क्रीपुर
sivan	क्वीन
siwan	क्वीन
sisva	यसेवा
siswa	यस्सेवा
cil	किल
csi	कसी
sikar	क्सिकर
seaten	केसेट
sitaram	कितरम
sitaharan	कितशारण
cpm	एपएमएस
cps	एसपीएस
cbse	क्साब
seem	एसीम
sim	एसआईएम
sealed	केसल
shield	क्षिल्ड
ccd	केसीडी
sugamata	कुगमता
sugmta	क्वग्रता
sujan	क्साजन
sujen	क्साइजन
suken	क्सुकें
sujain	क्साबें
sujhaati	क्शुरती
sujhati	क्शुड़ीत
sutali	क्सुली
sutli	क्सुली
suta	कुसा
sdueep	क्सूफी
sudip	कुसीप
sudhaargrah	कुद्वारगढ़
sudhargrih	कुद्वारशारी
sudhargruh	कुद्वगर्ह
sunaaron	क्योनारों
sunaron	क्योनरों
sunaseer	कुसानीसर
sunasir	क्सुनासी
suneeti	क्षुनीति
suniti	क्षीती
sunega	कुसेंगा
suneyga	क्योगेना
superhit	कुपारहित
supachy	कुपाश्ची
supachya	कुसाफ्याक
supachye	कुपाशे
subhaay	क्शूबय
subhay	क्शूब
surveen	कुरवीं
survin	क्रवरिन
surana	क्रारना
sulkhan	क्षुलखान
suljaayi	क्सुलजायी
suljayi	क्सुलाजी
suljhai	क्मुलझी
sulzai	क्सुलाजि
sultana	क्वुलना
sulaati	क्सौलती
sulati	क्सौलती
susanskrit	कस्सानुस्क्र
susanskrut	कससिंत्रक
suhagin	कुशागीन
soond	कंड
sund	कंद
suiyan	क्यूएन
sukhati	कुशाती
sukhti	कुश्ती
sukhakar	कुशकार
soochak	कुचाक
suchak	क्षुक
sooja	क्यूजा
suja	क्सुजा
suba	क्साबा
sube	क्सूब
sooraj	कुसार
suraj	क्राज़
surinaam	क्रूजिन
surinama	क्रूजिमा
suriname	क्रूजिनम
suryadev	क्रूजेव
sendha	नेंदहा
senvai	इेंवाई
sevai	ईसवाई
sensing	क्सेंसिंग
sexual	क्सेकुयल
saturday	क्सुत्राद्य
seti	केसी
seto	एस्टो
seth	केश
safety	केफेट्य
semen	केमें
semin	केमिन
self	केल्फ
selfie	क्लेफी
save	कवे
sev	एसवी
sevakon	केसावकों
sevkon	केस्लों
samuels	क्साबूमेस
celery	क्लेयरी
salary	क्गालरी
sakar	क्सार
socar	क्सोर
soccer	क्सॉकर
songs	कंग्स
solicitor	क्साइलॉकर
sochane	कोचने
sochne	कोचने
sonu	क्यूनो
soma	क्मोजा
spma	एसपेआ
somi	क्मोई
soy	क्साई
soya	क्यो
solitaire	क्सोलियर
soharai	कोशारी
sohrai	कोशराई
sohaval	कोशवाल
sohawal	कोशवाल
saunpane	क्सूपन
sonpne	क्सोपने
scala	क्साला
skala	क्सला
ski	एसकीआई
scootaron	क्सुतरों
scooteron	क्सूटरों
skootaron	क्सुतारों
scandinavia	क्ससंलिवासि
scaining	क्सिनिंग
scanning	क्सिंगिं
squash	क्सुच
squash	क्सुच
skhalan	क्षालान
stain	क्साएं
stan	क्षान
stop	कस्ट
stops	कस्टॉस
stone	क्सोटन
straws	क्षत्र
stress	क्स्सर्स
stra	क्ष्तम
stray	क्सर्य
stre	एस्ट्री
strocks	क्स्ट्रिक्स
strokes	क्सोर्सेस
stan	क्षान
stanadhari	क्षताराहिर
standhaari	क्षतांधारी
standhari	क्षत्रधानी
sthiti	क्षिति
stithi	क्षतीथी
stuti	क्सुटी
sthitiyaan	क्षितियां
sthitiyan	क्षितियां
sthitiyon	क्षतियों
sthool	क्षुल
sthul	क्षुल
sthoolta	क्षुतला
sthulata	क्षुतला
sneakers	क्सेनर्स
snickers	क्सिकर्स
snikarse	क्सिसर्स
spear	क्सापर
spell	क्सम्ली
spelar	क्साफाइर
speller	क्मैसलर
sprint	कस्प्ट्ट
sprit	कस्प्ट
spray	क्सारी
spry	एसपीएर
sfoorti	क्रफूर्टी
sfurti	क्रुफ्टी
sphoorti	क्रुप्ति
slide	क्साइड
slider	क्लाइडर
slaaidon	क्सालिदों
slidon	क्सलिड़
sliders	क्लाइडर्स
slides	क्लाइड्स
slice	क्साइल
slash	क्गाच्श
swaroopon	क्रबूरोप
swarupon	क्रवारोप
swa	एसवी
swaachaalit	क्षबातिक
swachalit	क्षवालित
swaarthparak	क्रवर्चपार्त
swarthparak	क्रवर्चाप्रक
swiftlate	क्विटल्टे
swiftlet	क्विफल्ट
sweekarte	क्वेस्कर्त
swikarte	क्वेस्टरी
sweet	क्वीत
sweep	क्वीप
sweccha	क्सेच्छा
swecha	क्षेवा
swechha	क्षेभा
sweta	क्वेता
swap	क्वाप
swipe	क्वेपी
handiya	झंडीय
handiyaa	झंडिया
hundiya	चुंडिया
hakikat	चकिकत
haqeeqat	चाकिकत
hathiya	चठिया
hamala	चमला
hamla	एहमाला
hamalavar	झमलावार
hamlavar	एंलवार
humlavar	चुमलावार
hamaal	अम्याल
hamal	एहमल
hercules	एएरेक्यूल्स
hardas	दर्डस
harpaal	दर्पाल
harpal	दर्पल
harvansh	चरवांश
haraval	चरवल
harawal	चरवल
hurricane	डूर्केन
harijan	झरिजन
hariyali	डरियाली
harshit	झर्शिट
haldi	एच्ली
halla	चल्ला
hawamahal	चवामहाल
hawalaat	चवलात
hawalat	चवलात
hasino	चसिनों
hasinon	एशिनों
haan	चान
han	एन
haanfte	झांफते
hafate	एफटे
hanfte	झंफते
higman	एचिमांग
hymen	एम्येन
hadauti	दड़ाउती
haani	चानी
hani	चनी
haarjeet	झार्जित
harjeet	झर्जित
haaranaa	चराना
harana	चरना
harna	चर्ण
haalchaal	चालचाल
haalchal	चालचाल
halchaal	चंचला
halchal	चलचल
halt	एचल
hault	चौल्ट
hahakar	चहकर
hingis	एंगिस
hindan	इंचान
hindon	इंडों
hijada	इक्गड़ा
hijda	इक्गड़ा
hijbul	इशबूल
hippo	इप्पो
hippopotamus	चिपपपोपुसम
himali	इपमीली
hilane	इलीने
hilne	एलने
hisham	इचिसम
heeraganj	चीरागंज
hiraganj	इहरागनज
heroes	एयरर्स
heros	एरर
hui	ुही
huin	छुएं
hooper	ऑपर
huppar	छप्पर
hupper	ऑप्पर
hegde	एचेज
hemvati	झेमवती
hemwati	झेमवती
help	एचल
helper	एचलपर
haito	चैटों
hairam	एचरम
harem	एर्पेम
herald	एचर्ल्ड
haive	एचवे
have	एववे
hong	ओंग
half	एचल
hoaf	ऑफ
hounga	ऑंडा
holding	चोल्डिंग
hoshangabaad	ओशनाग्बाद
hoshangabad	ओशनाग्बाद
hostes	ऑस्टेस
hostess	ऑच्सेस
ank	एंकी
anka	अंका
ankit	अनकित
anakon	अनाकों
ankhon	अंखों
ankon	अंकों
angkor	अंगकोर
ankor	एंकरो
angaarak	अंगारक
angarak	अंगरक
angraji	अंग्रजी
angreji	अग्रांजी
angrzi	अगर्मड़ी
antah	अंताह
antaha	अंताहा
antarmukh	अंतरमखु
antmurkh	अंतरमुख
antrmukh	अंतरमुख
andrabee	अंड्रबी
andrabi	अंडरबी
andha	अंधा
andhapan	अंधापन
andheri	अंधरी
ambaani	अंबानी
ambani	अंबानी
akram	अक्रम
acapulco	अक्पूल्को
akapulko	अकापूल्कों
akhand	आखंड
akhil	अखिल
agavai	अगवाई
agvaai	अगवाई
augustine	ऑगस्टनी
augustustine	औगसस्टरिस
agsta	अग्सता
agusta	अगस्ता
augusta	ऑगस्टा
agr	अग्र
agra	आगरा
achambha	अचंभा
achanbha	अचंभा
achievement	अचिसेनमीन
achivement	आपिवेमेंट
acchi	अच्छी
achchi	अच्छी
achhi	अछी
achyut	अशूत
achhanera	अच्चनेरा
achnera	अचनेरा
ajmeedh	अजमीध
ajhar	अज़हर
azhar	अज़हर
ajit	अजीत
agnat	अग्नत
agyaat	अज्ञात
agyat	अज्ञत
atakta	अटक्ता
atkata	अटकता
atake	आटके
atke	अटके
atwaal	अतवाल
atwal	अतवाल
attahasa	अत्थासा
atthaas	अट्थास
atthas	अट्शास
addon	एड्डों
athak	आथक
atharv	अथर्व
atharva	अथरावा
adad	अदाद
adaani	अदानी
adani	अदानी
advait	अदवाती
adwait	अदवाइत
advaitvaad	अद्वितवाद
advaitwad	अद्वैतवाद
adhivas	अधिवास
adhiwas	अधिवास
advivas	एडविवास
adhiik	अधिक
adhik	अधिक
adhyayanarat	अध्ययनारत
adhyayanrat	अध्ययनार्त
adhyaynrat	अध्ययनतार
anant	अनांत
ananti	अनांति
angadh	अंगढ़
angarh	अंग्रह
anchahe	अन्चाहे
anthak	अंथक
unthak	ऊंकाटक
anhoni	अनहों
anaavashyak	अनावाशकय
anavashyak	अनावश्यक
anavshyak	अनाभ्यक्ष
anawashyak	अनावश्यक
anik	अनिक
anishwarvadi	अनिश्वरवादी
anishwarwadi	अनिश्वरवादी
anukoltha	अनुकोल्ता
anukulata	अनुकूलता
anukulta	अनुकुलता
anuchit	अनुचित
anuprayogi	अनुपरायोगी
anuprayogon	अनुपारोगों
anupryogon	अनुपर्योगों
anureet	अनुरीत
anurit	अनुरित
anuthi	अनुथि
anudit	अनुद्तित
anyaay	अन्याय
anyay	अन्याय
anyaya	अन्याय
apnani	अपनानी
aparivartanshali	अपरिवर्तनशाली
aparivartansheel	अपरिवर्तनशील
aparivartanshil	अपरिवर्तनशील
apariharya	अपरिहार्य
aprihary	अप्रिहार्य
apriyary	अप्रियर्य
apavartit	अपवर्तित
apvartit	अपवर्तित
apvtrit	अप्वत्रित
apaardarshi	अपरादर्शी
apardarshi	अपरादर्शी
afroj	अफरेज
afroz	अफरेज
africa	एफ्रिका
abbaasi	अबबासी
abbasi	अबबासी
abhimat	अभिमत
abhishap	अभिशप
abhi	अभी
amjhera	अमझारा
amzera	अमजेरा
amargad	अमरदग
amargarh	अमरगरह
amarpaal	अमरपाल
amarpal	अमरपाल
amarohi	अमरोही
amrohi	अमरोही
amaanat	अमानत
amanat	अमानत
amanth	अमांठ
amaanati	अमानती
amanathi	अमानाहित
amanati	अमानती
amavasya	अमावस्य
amavsya	अमावस्य
amit	अमीत
amitao	अमीताओ
amitav	अमीतव
amuk	अमुक
amogh	आमोध
ambani	अंबानी
ayodhyaanaath	अयोधनाथ
ayodhyanaath	अयोधन्याथ
ayodhyanath	अयोधन्याथ
ayodhyeanath	अयोधन्यात
aradas	अरदास
ardaas	अर्दास
ardas	आर्डास
arabab	अरबब
arbab	अरबब
around	आरुंड
arjent	आरजेंट
urgent	उर्जेंट
arth	आर्थ
artha	अर्थ्ता
earth	ईर्थ
earthquake	एर्थिकाओ
arthon	अर्थों
arpit	आर्पिट
aryama	अर्यमा
aryma	अर्यमा
arymaa	अर्यमा
alankaar	अलंकार
alankar	अलंकर
alnkaar	अलंकर
alankaaron	अलंकरों
alankaron	अलंकरों
alnkaaron	अलंकरों
alnkaron	अलंकरों
alagavavadi	अलावावदादी
algavvadi	अलगववादी
algavwaadi	अलगववादी
alive	अलिव
alance	अलेंस
alayans	एलायंस
aliance	एलायंस
alind	अलींड
alai	अलाई
ali	अली
alii	एलियो
alonso	एलोंसो
aloso	एलोसो
alphabet	अल्बापेट
alba	अल्बा
avantipur	अवनतिपुर
awantipora	अवंतेपुरा
avaru	अवरू
avru	आवरू
awaru	अवारू
avarodhak	अवरोधक
avrodhak	अवरोधक
avrodhk	अवरोधक
avarnata	अवरणाता
avarnataa	अवरणता
avranta	अवरंता
avashist	अवशिष्ट
avshisht	अवशिष्ट
awashist	अवशिष्ट
avasthaayen	अवस्थाएं
avsthaen	अवस्थाएं
avsthayen	अवस्थाएं
awasthaen	अवस्थाएं
avi	आवी
avika	अविका
aviral	अविराल
avirl	अविरल
avishvaasniy	अविश्वासनीय
avishvasniy	अविश्वासनीय
avishvasniya	अविश्वासनीय
avisvasniya	अविस्वासनीय
aviva	अविवा
avaigyanic	अवय्ञानिकी
avaigyanik	अवय्ञानिकीन
avegyanik	अवेग्यनिक
ashaktataa	आषक्तता
ashktta	अष्कत्ता
asharaphi	अशार्फी
ashrafi	अशरफी
ashariri	आशारिरी
ashriri	आश्रिरी
ashrvatath	अश्र्वत्थ
ashvtth	अश्वत्थ
asamaany	असामान्य
asamany	असामान्य
asmanye	असमन्य
asaamnjsy	असंजस्य
asamanjasy	असमंदस्य
asamanjasya	असमंदस्य
asurakshit	असुरक्षित
asurkshit	असुरक्षित
aset	आसेट
asset	आसेट
asvabhavik	अस्वाभाविक
aswabhavik	अस्वाभविक
aswbhavik	अस्वभाविक
ahirauli	अहेरुली
item	इटम
items	इटम्स
idle	आईडल
idol	आईडल
icc	आईसीसी
iso	आईएसओ
ipc	आईपीसी
ipad	आईपड़
iris	आइरिस
ounce	आंकेस
aakaash	आकाश
aakash	आकाश
aake	आके
aakhet	आखेत
akhet	अखेत
aagat	आगत
aagaman	आगमन
aagman	आगमान
aagaa	आगा
aagah	आगाह
agha	आगा
aagaashe	आगाशे
aagashe	आगाशे
agashe	अगशे
aajmaanaa	आजमाना
aajmana	आजमाना
aazmaanaa	आजमाना
aata	आता
ata	अटा
atta	अट्टा
aatmayen	आत्मायें
atmaen	अत्माएं
aadaan	आदान
aadan	आदन
aadhaarit	आधारित
aadharit	आधारित
adharit	आधारित
aadheen	आधीन
aadhin	आधीन
aadhunik	आधौणिक
aanad	आनाद
aanand	आनंद
anand	आनंद
aapka	आपका
aapkaa	आपका
aapadaaaen	आपदाएं
aapdaein	आपदाएं
aapdayein	आपदाएं
aabantit	आबंतित
abantit	अबंतित
aabru	आबरू
abaru	अबरू
aamdan	आमदान
amadan	अमादन
aamdani	आमदानी
amadani	अमादनी
aamdi	आमडी
amdi	अमदी
aamod	आमोद
amod	अमोद
aayenge	आएंगे
aayojak	आयोजक
ro	रो
rp	आरपी
aaraam	आराम
aaram	आराम
aram	अरम
aarushi	आरूषी
arushi	अरूषी
artery	आर्टरी
order	ऑर्डर
aary	आर्य
aarya	आयरा
arya	अर्य
aaryika	आर्यका
aryika	अर्यका
aarya	आयरा
arya	अर्य
aryo	अर्यो
aaryan	आर्यन
arya	अर्य
aryon	अर्यों
aalsi	आलसी
alasi	अलासी
aalochak	आलोचक
alochak	आलोचक
aalochakon	आलोचकों
alochakon	आलोचकों
aalha	आलाहा
aalhaa	आलाहा
alha	अल्हा
allah	अल्लाह
aawaazen	आवाजें
aawajen	आवाजें
awaazen	आवाजें
awazen	आवाजें
aawajon	आवाजों
aawazon	आवाजों
awaazon	आवाजों
awazon	आवाजों
aavishakaar	आविषाकार
aavishkaar	आविष्कार
avishkar	अविष्कार
aavriti	आवृति
aavritti	आवृत्ति
avuti	अवुति
aavritiyon	आवृतियों
aavrittiyon	आवृत्तियों
avrutiyon	अवृतियों
aashanka	आशंका
ashanka	आशांका
aashriton	आश्रितों
ashriton	अश्रितों
aasaan	आसान
aasan	आसन
asan	असान
aastik	आस्तिक
astik	आस्टिक
aasteen	आस्तीन
aastin	आस्तिन
astin	अस्तिन
aahnaan	आहनान
aahnan	आह्नान
ahyan	अह्यान
england	इंजल्ड
engineer	इंजीनियर
introduction	इंट्रोडेक्शन
insurance	इंसरनेस
ear	इयर
eyer	एयर
eon	इयोन
iaan	इआन
ekattha	इकट्ठा
ikattha	इक्टठा
ekatthi	इकत्ठी
ekthi	एक्ठी
ikatthi	इक्टठी
ekaee	इकाई
ikai	इकाई
ekaeyon	एकाइयों
ikaiyon	ईकाईयों
ikarion	आइकरियों
economic	इकनॉमिक
ecuador	इकाउडोर
equador	एक्डोडर
equities	एक्यिटिस
ikvitija	इक्वितिबाज
ijaajat	इजाजत
ijajat	इजाजत
inhalation	इन्हालाइटन
inhaletion	इन्हेलाइन
ibija	इबिजा
ibiza	इबिजा
imaging	आमाइगंग
immune	इम्यून
elaichi	एलाचि
ilaichi	इलाची
ilayachi	इलायाची
ilayichi	इलायिची
elaaj	इलाज
ilaaj	इलाज
ilaj	इलाज
ishaak	इशाक
ishaaq	इशाक
ishak	इशाक
ishaara	इशारा
ishaaraa	इशारा
ishara	इशरा
ishita	इशिता
isht	इश्त
isteefe	इस्टेफ
istife	इस्टिफ
ea	इए
ia	इएआईए
eater	एतर
iter	इतर
email	एमेल
emailon	एमाइलों
emelon	एमीलों
evening	एविनिंग
east	आस्ट
ishat	इशात
isht	इश्त
isaaiyon	ईसाईयों
isaiyon	ईसाईयों
isayiyon	ईसाईयों
ikhrul	इखरूल
ukhrool	उखरोलू
ukhrul	उखुरूल
uchhalane	उछलाने
uchhalne	उछलने
ujback	उजबक्क
uzbek	उजबेक
uthane	उठाने
uthne	उठने
uthaakar	उठाकर
uthakar	उठाकर
uthaapatak	उठापातक
uthapatak	उठपाकक
uthen	उठें
udaan	उड़न
udan	उड़न
udaanaa	उड़ना
udana	उड़ना
udaane	उड़ने
udane	उड़ने
udaanen	उड़नें
udanen	उड़नें
udaanon	उड़नों
udanon	उड़नों
utane	उतने
utaney	उतने
utne	उतने
uttara	उतरा
uttra	उत्तरा
utpan	उत्पन
udant	उदांत
udghosh	उद्घोष
udar	उदार
uda	उड़ा
udaa	उड़ा
udakishuganj	उद्तिकिजंघ
udakishunganj	उद्तिकिंजंघ
unatees	यूनासिट
untees	उनटीस
uniyal	यूनियल
upadraviyon	उपद्रवायों
updravion	उप्दरवियों
updraviyon	उप्दर्वियों
upadravi	उपद्रवी
updravi	उपद्रवी
upadrawon	उपद्रवों
updravon	उपद्रवों
upneta	उपनेता
upabhokta	उपभोक्त
upbhokta	उपभोक्ता
uplaksh	उपलक्ष
uplakshay	उपलाक्षाय
uplakshya	उपलाश्यकाय
uplabdh	उपलब्द
uplabdhiyon	उपल्बाडियों
uplabdhi	उपलबढ़ी
upakhyaanon	उपखानियों
upakhyanon	उपख्यानों
ubuntu	उभमुत
ubaal	उबाल
ubal	उबाल
ubhaara	उभारा
ubhara	उभरा
umanath	उमानतः
umesh	उमेश
urf	उर्फ
urfa	उर्फा
urff	उर्रफ
urvarakon	उर्वरकों
urvarkon	उर्वर्कों
urwarakon	उर्वरकों
urvarata	उर्वरता
urvarta	उर्वरता
urwarta	उर्वरता
ulate	उलते
ulte	उल्टे
ulahana	उलहना
ulahna	उलहना
ulema	उलेमा
ulemaon	उल्यमाओं
usak	उसक
usaki	उसकी
uski	उसकी
usmein	उस्में
usmen	उस्में
usi	उसी
ustara	उस्तरा
udharv	उधार्व
udhrva	उध्रवा
urdhav	उर्धव
ushma	उष्म
rishicool	रिशिकल
rishikul	ऋषिकुल
rushikul	ऋषिकुल
enzyme	एंजिमाइ
anton	एंटन
entone	इंटोन
antoni	अंतोनी
antony	अंटोनी
endometrial	एंडम्रिटेलर
andreas	एंड्रेयस
als	अल्स
asi	आसी
eksaath	एकसाथ
eksath	एकस्थ
ekaki	इककी
xm	एक्सम
egmor	एजमर
egmore	एजमोर
aj	आज
agende	एजेंड
adp	एडीपी
adain	अदान
aden	अडेन
edan	ईडन
addi	अद्दी
eddi	एड्डी
eddie	एड्डी
eddy	एड्डी
apj	अपज
ftii	फ्टी
abbott	अबबोट
abut	अबूत
ebt	ईबीएटी
abvp	अब्ल्ड
abbot	अबब्टू
abbott	अबबोट
mta	एमएटए
mtake	मटके
mtec	मेट्स
mtech	मीथेक
emerald	इमरल्ड
emrald	एमराल्ड
emil	एमील
emile	एमील
emily	एमीली
amy	अम्य
emi	एमी
airway	एयरवाए
eyarave	एयरवे
eyarve	एयरवे
error	एर्रो
arica	एरिका
erica	एरिका
erika	एरिका
aerobic	एयरोबिक
aerobics	एयरोबिक्स
lte	एटीसी
lti	लीटी
allergic	एल्रिल्डिंग
eliminator	एलीमनियरट
aliens	एलियंस
alliance	एलायंस
asian	एसियान
sfc	एससीएफ
sk	एसकी
spf	एसपीपीए
association	एसोसिएशन
astar	अस्तर
aster	अस्ट्र
ester	एस्टर
aesthetics	एश्टेक्टिक्स
asthetic	एस्थेटिक
asfalt	असफल्त
asphalt	अस्पल्त
asphault	अस्पुलत
ahsaas	अहसास
ehsaas	एहसास
ehsas	एहसास
aisa	आईसा
eesa	आईसा
ainth	ऐंठ
end	एंड
enth	ईंथ
ainthey	ऐंठे
enthe	ऐंठे
aithan	ऐंठन
ethan	ऐंठन
ethhan	ऐंठन
ail	आईल
el	एल
alaps	अल्पस
alps	अल्प्स
aise	आईस
oxide	ऑक्सीड
oxy	ऑक्सी
offers	ऑफर्स
offshor	ऑफ्शर
offshore	ऑफ्फर्श
official	ऑफिसिल
okalahoma	ओटलाहा
oklahoma	ओटल्लाहा
oklahoma	ओटल्लाहा
ot	ओटी
opel	ओपल
obrayan	ओब्रेयन
obrien	ओबरिन
oran	ओरन
orian	ओरियान
orion	ओरियन
olavrishti	ओलविर्धित
ovum	ओवम
owem	ओवम
oceanic	ऑक्यांसिक
osaka	ओसका
auchity	ऑचिटी
auchitya	ऑचित्या
audhyogikaran	औद्योगुतिकार
audyogikarana	औद्योगिकारणा
audyogikikaran	औद्योबितिकारण
aurangabad	औरांगबाद
aurora	यूरोड़ा
aulakh	औलख
kankad	कांकड
kankar	कांकर
kankad	कांकड
kankar	कांकर
kangan	कांगन
conjunction	कांजुक्निटन
contemporary	कंट्पीरेब्रोम
kanthahar	कंठाहार
kanthhar	कंठहर
composer	कंपोर्स
kambalon	कांबलों
kanblon	कांबलों
consultant	कंसल्टांट
kakkad	कक्कड़
kakkar	कक्कर
kacche	कच्छे
kachche	कच्छे
karta	करता
katra	कतरा
cutlery	कलेरी
katlari	कत्लारा
katlary	कतलराय
katasaraj	कतसराज
kathfodave	कथोफदवे
kathfodve	कथफ्वेद
kathor	कटोर
kathore	कथोर
kanika	कनिका
kathai	कथाई
katthai	कट्ठाई
katthaii	कट्ठाई
convention	कन्वेशन
canals	कनैल्स
kanaal	कनाल
kanal	कनाल
kanindham	कनींधन
kaningham	कनिंघम
kanishthika	कनिष्ठिका
kanishthikaa	कनिष्ठिका
kanishtika	कनिष्तिका
kanyaayen	कन्यायन
kanyaein	कनाएं
kanyayen	कन्यायां
convention	कन्वेशन
convocation	कनिवेक्शन
cup	कप
kap	कप
kapda	कपड़ा
kpada	कपाड़ा
kapdo	कपडो
kapdon	कपड़ों
kaping	कपिंग
kping	कपिंग
kapolkalpana	कपोलोक्वना
kabaddi	कबाड़ुगी
kabr	कब्र
kabra	काबरा
kabren	कबरें
kabron	कबरों
kamjor	कमजोर
kamzor	कमजोर
kamatar	कमातर
kamtar	कमतार
kalamjeet	कल्मजित
kamaljeet	कमलजीत
kamaauu	कमाऊ
kamau	कमाऊ
kamaate	कमाते
kamate	कमते
kamere	कमेरे
kmere	केमरे
karanj	करणज
kranj	क्रांज
karanjiya	करणजिया
kardhe	कर्धे
karghe	कर्घे
karachana	कराचना
karchhana	कर्चहना
karna	करना
karpatri	कर्पतरी
karam	कराम
karoor	करूर
karur	करूर
karnataka	कर्णतका
karvi	करवी
kurvi	कुर्वी
kalmein	कालमें
kalmen	कालमें
kalraj	कलराज
kalika	कालिका
kalpanaon	कल्पनाओं
kalpnaon	कल्पनाओं
kavvaliyon	कव्वालियों
qawwaliyon	कवालायिनी
kavvali	कववाली
qawwali	कववाली
kashton	कष्टों
kasarat	कसरत
kasrat	कसरत
kasara	कसरा
kasida	कसीदा
kahane	कहाने
kahne	कहने
kahlaya	कहलाया
kahaniyon	कहानियों
kile	किले
kanji	कांजी
cant	केंट
kant	कांट
kanti	कांटी
kakoo	काकू
kaku	काकू
kaagaj	कागज
kaagaz	काग़ज़
kagaj	कागज
kagaz	काग़ज़
kaaji	काज़ी
kaji	काजी
kazi	काज़ी
ank	अंक
anka	अंका
ankit	अंकीत
anakon	अनाकों
ankhon	अंखों
ankon	अंकों
angkor	अंगकोर
ankor	अंकोर
angaarak	अंगरक
angarak	अंगरक
angraji	अंग्रजी
angreji	अंग्रजी
angrzi	अंग्रजी
antah	अंताह
antaha	अंताहा
antarmukh	अंतरमुख्य
antmurkh	अंतमुर्ख
antrmukh	अंतरमुखी
andrabee	अंद्रबी
andrabi	अंद्रबी
andha	अंधा
andhapan	अंधपन
andheri	अंधेरी
ambaani	अंबनी
ambani	अंबनी
akram	अक्रम
acapulco	अकैपूल्क
akapulko	अकापुलको
akhand	अखंड
akhil	आखिल
agavai	अगवाई
agvaai	अगवाई
augustine	आगूस्थीन
augustustine	आगस्ट्शसन
agsta	अगस्ता
agusta	अगूसता
augusta	आगूस्ता
agr	एगर
agra	आगरा
achambha	अचंभा
achanbha	अखंछा
achievement	आखिवेमेंट
achivement	आखिवेंटें
acchi	अच्छि
achchi	अच्छी
achhi	अची
achyut	अच्छुत
achhanera	अच्छानेर
achnera	आच्नेरा
ajmeedh	आजमीद
ajhar	आभर
azhar	आजहर
ajit	आजीत
agnat	अग्नत
agyaat	अज्ञात
agyat	अज्ञात
atakta	अटकता
atkata	अटकाता
atake	अटके
atke	अटके
atwaal	अटवाल
atwal	अटवाल
attahasa	अत्हासा
atthaas	अत्थास
atthas	अत्थास
addon	अड़ों
athak	अठक
atharv	अठर्व
atharva	अठर्व
adad	आदाद
adaani	अदानी
adani	अदानी
advait	आदवाति
adwait	आडवाईट
advaitvaad	आदवावताद
advaitwad	आदवावत्याद
adhivas	अधिवास
adhiwas	अधिवास
advivas	आदविवास
adhiik	अधिक
adhik	अधिक
adhyayanarat	अध्यायनार्त
adhyayanrat	अध्ययनार्त
adhyaynrat	अध्ययन्रत
anant	अनंत
ananti	आनंति
angadh	अंगद
angarh	अंगारह
anchahe	अंचाहे
anthak	अंथक
unthak	उंतक
anhoni	अन्होंही
anaavashyak	अनावाश्यक
anavashyak	अनावाश्यक
anavshyak	अनावश्यक
anawashyak	अनावाश्यक
anik	अनिक
anishwarvadi	अनिश्वरवादी
anishwarwadi	अनिश्वरवादी
anukoltha	अनुकूल्ठा
anukulata	अनुकूलता
anukulta	अनुकूलता
anuchit	अनुचित
anuprayogi	अनुपारकियों
anuprayogon	अनुप्रयोगों
anupryogon	अनुप्रकोयों
anureet	अनुरीत
anurit	अनुरीत
anuthi	अनुथी
anudit	अनुदित
anyaay	अन्याय
anyay	अन्यय
anyaya	अन्याय
apnani	अपनानी
aparivartanshali	अपरिवर्तनशाली
aparivartansheel	अपरिवर्तनशील
aparivartanshil	अपरिवर्तनशील
apariharya	अपरिहार्य
aprihary	अप्रेहरी
apriyary	अप्रियारी
apavartit	अपवर्तित
apvartit	अपवर्तित
apvtrit	अपवत्रित
apaardarshi	अपारदर्शी
apardarshi	अपरदर्शी
afroj	अफ्रोज
afroz	अफ्रोज
africa	अफ्रिका
abbaasi	अब्बासी
abbasi	अब्बासी
abhimat	अभिमत
abhishap	अभिशाप
abhi	अभी
amjhera	अमझारे
amzera	अम्जेरा
amargad	अमरगढ़
amargarh	अमरागढ़
amarpaal	अमरपाल
amarpal	अमरपाल
amarohi	अमारोही
amrohi	अमरोही
amaanat	अमानत
amanat	अमानत
amanth	अमांत
amaanati	अमानती
amanathi	अमानाथी
amanati	अमानती
amavasya	अमवाश्य
amavsya	अमावस्य
amit	अमित
amitao	अमिता
amitav	अमिताव
amuk	आमूक
amogh	अमोग
ambani	अंबनी
ayodhyaanaath	अयाधियानत
ayodhyanaath	अयोध्यानत
ayodhyanath	अयोध्यानत
ayodhyeanath	अयोधियानत
aradas	अरादास
ardaas	अर्दास
ardas	अर्दस
arabab	अरबब
arbab	अरबब
around	अरोंड
arjent	अरेजेंट
urgent	अर्गेंट
arth	आर्थ
artha	अर्था
earth	इर्थ
earthquake	इर्थकूका
arthon	आर्थों
arpit	एर्पिट
aryama	आर्यामा
aryma	आर्यम
arymaa	आर्माया
alankaar	अलंकर
alankar	अलंकर
alnkaar	अलंकार
alankaaron	अलंकरों
alankaron	अलंकरों
alnkaaron	अलंकरों
alnkaron	अलंकरों
alagavavadi	अलंगववादी
algavvadi	अल्लावदवी
algavwaadi	अल्लावदवि
alive	अलीवे
alance	एलंस
alayans	अलायंस
aliance	एलाइंस
alind	अलिंड
alai	अलाई
ali	एली
alii	अली
alonso	आलोंसों
aloso	आलोसों
alphabet	अल्फबेत
alba	अलबा
avantipur	अवंतपुरु
awantipora	अवनतीपुर्ता
avaru	आवारू
avru	अवृ
awaru	आवारू
avarodhak	आवरूद्कक
avrodhak	अवरोधक
avrodhk	अवरूद्क
avarnata	आवरणता
avarnataa	आवर्णता
avranta	अवरंता
avashist	अवशीस्त
avshisht	अवशीष्ट
awashist	अवशिस्त
avasthaayen	अवस्थायन
avsthaen	अवस्थाएं
avsthayen	अवस्थाएं
awasthaen	अवस्थाएं
avi	अवी
avika	अविका
aviral	अविराल
avirl	एविर्ल
avishvaasniy	अविश्वरियी
avishvasniy	अविश्वनियी
avishvasniya	अविश्रविनय
avisvasniya	अविस्रविनय
aviva	अविवा
avaigyanic	अवैज्ञानिक
avaigyanik	अवैज्ञानिक
avegyanik	अवैग्ञानिक
ashaktataa	आशाकताता
ashktta	अष्कताता
asharaphi	अशापृह
ashrafi	आश्रफी
ashariri	आशारीरी
ashriri	आश्रीरी
ashrvatath	आश्रवताथ
ashvtth	अश्वत्थ
asamaany	असामान्य
asamany	असमान्य
asmanye	असमान्य
asaamnjsy	असामंज्य
asamanjasy	असमानज्ञ
asamanjasya	असमंजायस
asurakshit	असुरक्षित
asurkshit	असुरक्षित
aset	एसेट
asset	एसेट
asvabhavik	अस्वभाविक
aswabhavik	अस्वाभाविक
aswbhavik	अस्वभाविक
ahirauli	अहिरावुली
item	इतेम
items	इतेम्स
idle	इडल
idol	आइडॉल
icc	आईसीसी
iso	आईएसए
ipc	आईपीसी
ipad	इपाद
iris	आइरिस
ounce	ऊंस
aakaash	आकाश
aakash	आकाश
aake	आले
aakhet	आखेत
akhet	अखेत
aagat	आगत
aagaman	आगमन
aagman	आगमान
aagaa	आगा
aagah	आगाह
agha	आघा
aagaashe	आग्षे
aagashe	आग्षे
agashe	अग्षे
aajmaanaa	आजमाना
aajmana	आजमाना
aazmaanaa	आजमाना
aata	आता
ata	अटा
atta	अट्टा
aatmayen	आत्मयें
atmaen	आत्माएं
aadaan	आदान
aadan	आदन
aadhaarit	आधारित
aadharit	आधारित
adharit	आधारित
aadheen	आधीन
aadhin	आधिन
aadhunik	आधुनिक
aanad	आनाद
aanand	आनंद
anand	आनंद
aapka	आपका
aapkaa	आपका
aapadaaaen	आपदाएं
aapdaein	आपदाएं
aapdayein	आपदाएं
aabantit	आजंतित
abantit	अजंतित
aabru	आब्रू
abaru	अबारु
aamdan	आमदान
amadan	आमादान
aamdani	आमदानी
amadani	अमादानी
aamdi	आमदी
amdi	आमडी
aamod	आमोद
amod	अमोद
aayenge	आयेंगे
aayojak	आयोजक
ro	रो
rp	आरपी
aaraam	आराम
aaram	आराम
aram	आराम
aarushi	आरुषि
arushi	आरुशी
artery	आर्टेरी
order	ऑर्डर
aary	आरे
aarya	आर्य
arya	आर्य
aaryika	आरियका
aryika	आरियका
aarya	आर्य
arya	आर्य
aryo	आरोय
aaryan	आर्यन
arya	आर्य
aryon	आरें
aalsi	आलसी
alasi	अलसी
aalochak	आलोचक
alochak	आलोचक
aalochakon	आलोचकों
alochakon	आलोचकों
aalha	आल्ह
aalhaa	आल्हा
alha	अल्हा
allah	अल्लाह
aawaazen	आवाजें
aawajen	आवाजें
awaazen	आवाजें
awazen	आवाजें
aawajon	आवाजों
aawazon	आवाजों
awaazon	आवाजों
awazon	आवाजों
aavishakaar	आविष्कार
aavishkaar	आविष्कार
avishkar	अविष्कार
aavriti	आवृति
aavritti	आवृत्ति
avuti	आवूटी
aavritiyon	आवृतियों
aavrittiyon	आवृतितियों
avrutiyon	आवृतियों
aashanka	आशांका
ashanka	आशांका
aashriton	आश्रितों
ashriton	आश्रितों
aasaan	आसान
aasan	आसन
asan	आसान
aastik	आस्तिक
astik	आस्तिक
aasteen	आस्तें
aastin	आस्तिन
astin	आस्तिन
aahnaan	आह्नान
aahnan	आहनान
ahyan	अह्यान
england	इंगलैड
engineer	इंजीनियर
introduction	इंटर्क्शक्शन
insurance	इंसर्नेस
ear	इयर
eyer	आयर
eon	इयोन
iaan	ईएएं
ekattha	इकट्ठा
ikattha	इक्टठा
ekatthi	इकट्थी
ekthi	इक्थी
ikatthi	इकटठी
ekaee	इकाई
ikai	इकाई
ekaeyon	इकाइयों
ikaiyon	ईकाइयों
ikarion	इकारियों
economic	इकोनॉमिक
ecuador	इकाउड़ो
equador	एकवास
equities	इक्वीशिय
ikvitija	इक्वितिजा
ijaajat	इजाज़त
ijajat	इज़ाजत
inhalation	इन्हालेशन
inhaletion	इन्हेलिशन
ibija	इबिजा
ibiza	इबिजा
imaging	इमाइजिंग
immune	इम्यून
elaichi	एलीकी
ilaichi	इलाइची
ilayachi	इलायाची
ilayichi	इलायिचि
elaaj	एलाज
ilaaj	इलाज
ilaj	इलाज
ishaak	इशाक
ishaaq	इशाक
ishak	इशाक
ishaara	इशारा
ishaaraa	इशारा
ishara	इशारा
ishita	इशिता
isht	इष्ट
isteefe	इस्तीफा
istife	इस्तफि
ea	इए
ia	इए
eater	एटर
iter	आईटर
email	एमाइल
emailon	एमायलों
emelon	एमिलों
evening	एवेंज
east	ईस्ट
ishat	इश्छत
isht	इष्ट
isaaiyon	ईसाईयों
isaiyon	ईसाइयों
isayiyon	ईसायियों
ikhrul	इखृचल
ukhrool	उख्रुल
ukhrul	उख्रुल
uchhalane	उछलने
uchhalne	उछलने
ujback	उजबाक
uzbek	उजबेक
uthane	उठाने
uthne	उठाने
uthaakar	उठाकर
uthakar	उठाकर
uthaapatak	उठपताक
uthapatak	उठपटक
uthen	उठाएं
udaan	उड़ान
udan	उदान
udaanaa	उड़ना
udana	उड़ना
udaane	उड़ाने
udane	उड़ने
udaanen	उदानें
udanen	उदानें
udaanon	उदानों
udanon	उदानों
utane	उताने
utaney	उतने
utne	उतने
uttara	उतरा
uttra	उतर्ता
utpan	उत्पन
udant	उदंत
udghosh	उद्घोष
udar	उदार
uda	उड़ा
udaa	उड़ा
udakishuganj	उदाकिष्गाण
udakishunganj	उदाकिषंग्णों
unatees	उनाटिस
untees	उन्तीस
uniyal	उनियाल
upadraviyon	उपदर्वियों
updravion	उपद्वरियों
updraviyon	उपद्रवायों
upadravi	उपदर्वी
updravi	उपद्रवी
upadrawon	उपदारवों
updravon	उपद्रवों
upneta	उपनेता
upabhokta	उपभक्ता
upbhokta	उपभक्त
uplaksh	उपलक्ष
uplakshay	उपलक्षय
uplakshya	उपलक्ष्य
uplabdh	उपलाब्ध
uplabdhiyon	उपलाबाधियों
uplabdhi	उपलाबदी
upakhyaanon	उपख्याओं
upakhyanon	उपख्यानों
ubuntu	उबूंतु
ubaal	उबाल
ubal	उबल
ubhaara	उभरा
ubhara	उभरा
umanath	उमानत
umesh	उम्शे
urf	ऊर्फ
urfa	उर्फा
urff	ऊरफ्फ
urvarakon	उर्वरकों
urvarkon	उर्वरकों
urwarakon	उर्वारकों
urvarata	उर्वरता
urvarta	उर्वर्ता
urwarta	ऊरवरता
ulate	उलाते
ulte	उलते
ulahana	उलाहना
ulahna	उलाहना
ulema	उलेमा
ulemaon	उल्मेयन
usak	उसक
usaki	उसकी
uski	उसकी
usmein	उसमें
usmen	उसमें
usi	उसी
ustara	उस्तरा
udharv	उद्धर
udhrva	उद्र्व्र
urdhav	उर्ध्व
ushma	उष्मा
rishicool	रिश्यूकल
rishikul	ऋषिकोल
rushikul	ऋषिकोल
enzyme	इनजिमा
anton	एंटन
entone	एन्टोन
antoni	एंटोनी
antony	एंटोनी
endometrial	एनडोमेशलर
andreas	एंड्रेस
als	अल्स
asi	एसी
eksaath	एक्सत
eksath	एक्सत
ekaki	एककी
xm	एचम्स
egmor	एजमर
egmore	एज़मोर
aj	आज
agende	एजेंड
adp	एडीपी
adain	अदानी
aden	आड़ें
edan	एडन
addi	आड्डी
eddi	एडीडी
eddie	एडीडी
eddy	एडीडी
apj	अपज
ftii	फ़ीटी
abbott	अब्ब्ट्ट
abut	आबूट
ebt	इफ्क
abvp	अबफ्प
abbot	अब्बोत
abbott	अब्ब्ट्ट
mta	एमटीए
mtake	मटेक
mtec	मेटीक
mtech	मेट
emerald	एमरेल्ड
emrald	एमर्ल्ड
emil	एमिल
emile	एमिले
emily	एमिली
amy	एम्य
emi	एमी
airway	एयरवे
eyarave	एयरवे
eyarve	एयर्वे
error	एरर
arica	एरिका
erica	एरिका
erika	एरिका
aerobic	एयरबिक
aerobics	एयरबिक्स
lte	लेट
lti	लटी
allergic	अल्रेजिक
eliminator	एलिमीनेटर
aliens	अलिज्स
alliance	एलायंस
asian	एशियाई
sfc	एसपीची
sk	एसीके
spf	एसपीफी
association	एसोसिएशन
astar	आस्तर
aster	एस्टर
ester	एस्टर
aesthetics	एस्थेटिक्स
asthetic	एस्थेटिक
asfalt	एसफॉल्ट
asphalt	असेफल्ट
asphault	एस्फॉट
ahsaas	अहसास
ehsaas	एहसास
ehsas	एहसास
aisa	ऐसा
eesa	एसा
ainth	ऐंठ
end	एंड
enth	ऐंठ
ainthey	ऐंठे
enthe	ऐंठे
aithan	ऐंठन
ethan	इथन
ethhan	इथान
ail	ऐल
el	एल
alaps	अलाप्स
alps	एल्प्स
aise	एसे
oxide	ऑक्सीड
oxy	ऑक्सी
offers	ऑफर्स
offshor	ऑफशियोर
offshore	ऑफशायर
official	ऑफिसियल
okalahoma	ओकलोहामा
oklahoma	ओकलोहामा
oklahoma	ओकलोहामा
ot	ओटी
opel	ओपेल
obrayan	ओब्रैन
obrien	ऑबरीन
oran	ओरन
orian	ओरियन
orion	ओरियन
olavrishti	ओलेवृष्टि
ovum	ओवम
owem	ओवर
oceanic	ओकेनिक
osaka	ओसका
auchity	आशिटी
auchitya	आछितिया
audhyogikaran	औद्योगिकारण
audyogikarana	औद्योगिकना
audyogikikaran	औद्योगिकिसालन
aurangabad	औरंगबद
aurora	औरोरा
aulakh	औकुख
kankad	कांकड़
kankar	कंकर
kankad	कांकड़
kankar	कंकर
kangan	कंगन
conjunction	कॉंजेशनों
contemporary	कंटीमर्वरी
kanthahar	कांठहर
kanthhar	कंठार
composer	कंपोसर
kambalon	कांबलों
kanblon	कांबलों
consultant	कंसल्टेंट
kakkad	काक्कड़
kakkar	कक्कर
kacche	कच्चे
kachche	कच्छे
karta	करता
katra	कतरा
cutlery	केटरी
katlari	कतलरी
katlary	कतलरी
katasaraj	कतसर्ज
kathfodave	कठोफवाड़े
kathfodve	कथफूरवे
kathor	कथोर
kathore	कथोरे
kanika	कनिका
kathai	कथाए
katthai	कट्ठाई
katthaii	कट्थाई
convention	कन्वेशन
canals	कैनाल्स
kanaal	कनाल
kanal	कनाल
kanindham	कनींधम
kaningham	कनिमघन
kanishthika	कनिष्ठिकता
kanishthikaa	कनिष्ठिका
kanishtika	कनिष्टिकता
kanyaayen	कन्याएं
kanyaein	कन्याएं
kanyayen	कन्याएं
convention	कन्वेशन
convocation	कन्योटेशन
cup	कप
kap	कप
kapda	कपड़ा
kpada	कपाड़ा
kapdo	कपड़ो
kapdon	कपड़ों
kaping	कापिंग
kping	क्पिंग
kapolkalpana	कॉपलकन्लापा
kabaddi	कबदड़ी
kabr	कब्र
kabra	कबरा
kabren	कब्रें
kabron	कब्रों
kamjor	कमजोर
kamzor	कम़ोजोर
kamatar	कमतर
kamtar	कमतर
kalamjeet	कलामजीत
kamaljeet	कमालजीत
kamaauu	कमाऊ
kamau	कमाऊ
kamaate	कमाते
kamate	कमते
kamere	कमेरे
kmere	कमरे
karanj	करांज
kranj	क्रांज
karanjiya	करंजिया
kardhe	कार्धे
karghe	कार्घे
karachana	कराचना
karchhana	कार्च्छन
karna	कर्ण
karpatri	कर्पत्री
karam	करम
karoor	करुर
karur	करुर
karnataka	कर्णताका
karvi	कारवी
kurvi	कुर्वी
kalmein	कालमें
kalmen	कलमें
kalraj	कलराज
kalika	कालिका
kalpanaon	कल्पनाओं
kalpnaon	कल्पनाओं
kavvaliyon	कववालियों
qawwaliyon	कवविलियों
kavvali	कववाली
qawwali	क़व्वाली
kashton	काश्तों
kasarat	कसरत
kasrat	कसरत
kasara	कसरा
kasida	कसीदा
kahane	कहाने
kahne	कहने
kahlaya	कहलाया
kahaniyon	कहानियों
kile	कीले
kanji	कांजी
cant	केंट
kant	कांत
kanti	कांटी
kakoo	काकू
kaku	काकु
kaagaj	कागज
kaagaz	कागज
kagaj	कागज
kagaz	कागज
kaaji	काजी
kaji	काजी
kazi	काजी
qazi	काज़ी
kajoo	काजू
kaju	काजू
kapadi	कपड़ी
kapdi	कपड़ी
kamraj	कमराज
kamottejana	कामतेत्गना
kamottejna	कामोत्तेगन
kailana	कैलना
kaylana	कायलाना
carfi	कारफी
karki	कारकी
kartik	कार्टिक
karyakartaon	कार्यकर्ताओं
karykartaaon	कार्यकर्ताओं
karykartaon	कार्यकर्ताओं
karyabhar	कार्यभर
karybhar	कार्यभर
karyarat	कार्यारत
karyrat	कार्यरत
kaalpi	कालपी
kalapi	कलापी
kalpi	कल्पी
kalika	कालिका
kalighat	कलीघात
coldvel	कॉल्डेवल
kaldvel	कालदवाल
kaldwell	काल्डविल
kaav	काव
kav	काव
kaasht	काश्त
kasht	काष्ट
kasim	कसीम
qasim	कासिम
kasimabad	कसीमाबाद
kiya	किया
kiliyan	किलियां
killat	किल्लत
killi	किल्ली
kisaani	किसानी
kisani	किसनी
kisanon	किसनों
keede	कीडे
kide	कीड़े
keynote	केयनोट
kinote	कीनोटे
kiratpur	किरातपुर
kundal	कुंडल
kundaliya	कुंडलीय
kundaliyan	कुंडलियां
kutta	कुट्टा
kuposhit	कुपोषित
kumau	कुमाऊ
kumavat	कुमावट
kumawat	कुमावट
kural	कुरल
kurmi	कुर्मी
kursiyon	कुर्सियों
kush	कुश
kushaan	कुशान
kushan	कुशान
kusumalataa	कुसुमलता
kusumalta	कुसुमलता
kusumlata	कुसुमलता
koot	कूट
kut	कुट
kritika	कृतिका
kpo	कपो
canterbari	कैंतरबारी
canterbury	कैंटरब्यू
candidate	कांडिडाट
katrina	काटरिना
caitlyn	कैकलीं
cateline	कैटेलिन
catlin	कैटलीन
cadmium	कैडमियम
catholic	कैथलिक
catholicon	कैथलिकों
kaetholikon	कैथ्लिकों
capacitor	कैपोकिटर
carat	कारत
cavity	केविटी
cavalry	केवलरी
kaivelari	कैवेलारी
complex	कंपाल्क्ट
kocchi	कोची
kochi	कोची
corridor	कॉर्डियर
corolla	कोरोला
korola	कोरोला
caolan	कॉलान
colan	कोलन
colon	कोलों
calling	कॉलिंग
koling	कोलिंग
colorado	कलोर्डो
kolorado	कोलोर्डों
kaushal	कौशल
kaushalata	कौशलता
kaushalta	कौशलता
kaushambi	कौशंबी
cute	कुटे
quete	क्वेट
cube	कूबे
cubeck	कूबेक
quebec	क्वाबिस
cubes	कूबेस
krantiyon	क्रांतियों
cric	क्रिक
crick	क्रिक
cricket	क्रिक्ट
cricketer	क्रिक्टेड
cricketing	क्रिकिटंग
kriyayog	क्रियायोग
christian	क्रिस्टियन
kruger	क्रूर
craig	क्रैग
creg	क्रेग
cradle	क्रैडल
chrom	क्रोम
chrome	क्रोमे
client	क्लिंट
clock	क्लॉक
clasen	क्लेसन
classen	क्लासेन
classon	क्लास्स
clay	क्ले
claris	क्लारिस
cleris	क्लीर्स
clerys	क्लायर्स
quantico	क्वांचिटों
queens	क्विंस
kshitij	क्षितिज
shitij	खिषीतिज
kshin	क्षीण
shin	क्षिन
kshetron	क्षेत्रों
shetron	क्षेत्रों
khand	खांड
khanda	खांडा
khachakhach	खाचचाच
khajarana	खजरना
khajraana	खजराना
khajrana	खजराना
khatakati	खतकती
khatakti	खटकती
kihatkati	किहाताकि
khattapan	खट्टपन
khat	खाट
khani	खानी
khanik	खानिक
khanikarm	खानीकर्म
khanikarma	खानीकर्मा
khanikarmi	खानीकर्मी
khapat	खपत
khariya	खरिया
khalnayak	खालनायक
khaaskar	खासकर
khaskar	खासकर
khaastaur	खासतौर
khastaur	खासतौर
khaibar	खैबर
khyber	खाब्यर
khaein	खाएं
khaen	खाएं
khayen	खाएं
khaate	खाते
khaatey	खाटे
khate	खाटे
khal	खल
khinchakar	खिंचकर
khinchkar	खिंचकर
khilana	खिलना
khinchkar	खिंचकर
khuda	खुदा
khudai	खुड़ाई
khurapka	खुरपका
khurpaka	खुरपाका
khurasan	खुरसन
khushiyan	खुशियां
khene	खेने
khaini	खानिय
khairati	खैराती
khoikhoi	खोखियों
khoya	खोया
gangrel	गांग्रेल
gangaajal	गंगाजल
gangajal	गंगाजल
gandaki	गंदाकी
gandki	गंदकी
gandh	गंध
gandha	गंधा
gae	गाई
gaye	गाये
gajara	गजरा
gajra	गजरा
gadkar	गाडकार
ganapati	गनपती
ganpati	गनपति
gatisheel	गतिशील
gatishil	गतिशील
gatishilata	गतिशिलता
gadadhar	गद्धार
gammat	गमतम
gaya	गाया
garibi	गर्बी
garjana	गरजाना
galgand	गैलगंड
gahmagahmi	गहमाधगी
gemhagehmi	जेमहगढ़ी
ganguly	गैंगुली
gaanth	गण्ठ
ganth	गंथ
gaanthe	गांथे
ganthe	गंठे
ganthen	गंथें
ganthon	गंथों
gaen	गैन
gayen	गाएं
gazi	गाजी
gajipur	गाजीपुर
gazipur	गाज़ीपुर
gayatri	गैथारी
gayitri	गैयतीर्
gaytri	गैत्री
gidgidate	गिड्गाइडट
ginate	गिनते
ginte	गिनते
girkar	गिरकर
girijaghar	गिरिजघर
girjaghar	गिरजाघर
girijagharon	गिरिजघरों
girjagharon	गिरजागरों
girati	गिराती
girti	गिरती
girish	गिरिश
guan	गुण
gujar	गुजर
gujarata	गुजराता
gujarta	गुजरता
gujarate	गुजराते
gujarte	गुजरते
gujarana	गुजराना
gujarna	गुजरना
gujara	गुजरा
gujare	गुजरे
gutta	गुट्टा
gthalidar	ग्लाफिड़ार
guthalidar	गुतालिगाड़ा
gudna	गुडना
gumaan	गुमान
guman	गुमन
gulshan	गुलशान
gunga	गुंगा
grihnagar	गृहनगर
gruhnagar	गृहनागर
galaxion	गैलेशियों
galaxiyon	गैलक्सियों
galaxyon	गैलक्षीन
gochar	गोचर
gouchar	गौचार
godara	गोदारा
gopichand	गोपीचंद
gomake	गोमके
gomke	गोमके
goel	गॉयल
goyal	गोयाल
gosvaami	गोस्वामी
gosvami	गोस्वामी
goswami	गोस्वामी
gaumukh	गौमुख
gomukh	गोमुख
gaumutr	गौमूत्र
gaumutra	गौमूत्र
gowmutra	गौमात्र
granthiyaan	ग्रांतियां
granthiyan	ग्रांतियां
grandhiyon	गृणदियों
granthiyon	ग्रांथियों
greest	ग्रीस्ट
greist	ग्रेस्ट
grist	ग्रिस्ट
greg	ग्रेग
granite	ग्रेनिटे
grenite	ग्रेनिट
grandson	ग्रेंस्सन
gross	ग्रोस
ghataatop	घटातपु
ghatatop	घटटपो
ghataayaa	घटाया
ghataya	घटाया
ghanakar	घनकर
ghabrahat	घबराहट
ghasi	घासी
ghisai	घिसाई
ghisi	घीसी
ghise	घीसे
ghumakkadi	घुमकाकड़ी
ghumakkdi	घुमक्किद
ghumakkadon	घुमक्कादों
ghumakkaron	घुमाककरों
ghumakkdon	घुमक्दकों
ghummakkadon	घूममकाकदों
ghumaan	घुमान
ghuman	घुमान
ghoonsa	घूंसा
ghunsa	घुंसा
ghongha	घोंघा
ghontane	घोंटने
ghontne	घोंटने
ghot	घोट
ghodi	घोडी
ghost	घोष्ट
changul	चांगुल
chand	चांड
chandan	चंदन
chandana	चंदना
chandu	चंदू
chandon	चंदों
chandrabali	चंद्रबाली
chandramaon	चंद्रमाओं
chakatte	चकते
chaktte	चक्तते
chakkar	चक्कर
chkkar	चक्कर
chakshu	चाक्षु
chatagaon	चटगान
chatgaon	चटगां
chadhane	चढ़ाने
chadhne	चढ़ने
chaturdik	चतुरद्कि
chatunshkoniy	चतुनस्चियों
chatushkoniy	चतुशकूनियों
chatushkoniya	चतुशकूनियों
channa	चानना
chabate	चबाते
chabutare	चाबूतरे
chabutre	चाबूतरे
chamakna	चमकना
chamkana	चमकाना
charas	चारस
charit	चारित
charcha	चर्चा
churcha	चर्चा
charchaon	चर्चाओं
chalenge	चालेंगे
chlenge	क्लेंज
chahunaur	चहुनौर
chahunor	चहुनोर
chanval	चंवल
chanwal	चंवल
chachaji	चचाजी
chadar	चादर
chadaron	चादरों
chadron	चादरों
chan	चैन
chanan	चानन
chaplusi	चालपुसी
chayal	चयाल
char	चर
charon	चरों
charge	चार्ज
chart	चर्त
charton	चर्तों
charts	चार्ट्स
chaalit	चालित
chalit	चलित
chikitsak	चिकित्सक
chikitsakon	चिकित्सकों
chikhali	चिखली
chiththi	चिथ्ति
chitthi	चित्थी
chithhi	चिथी
chiththi	चिथ्ति
chitthi	चित्थी
chidchidapan	चिड़चिड़ापान
chidchidapan	चिड़चिड़ापान
chidhate	चीदहेत
chidhte	चीद्ते
chithrkar	चित्रकर
chitrkar	चित्रकर
chipakane	चिपकाने
chipakne	चिपकने
chipkane	चिपकाने
chimati	चिमती
chimti	चिमती
chillane	चिल्लें
chee	ची
chi	ची
chuka	चुका
chune	चुने
chunar	चुनर
changed	चेंगेड
chetti	चेत्ती
chennai	चेननी
chero	चेरो
chest	चेस्ट
championship	चांपनिपूशी
chor	चोर
choro	चोरो
choron	चोरों
chauk	चौक
chowk	चौक
chauka	चौका
chuka	चुका
chaukiyan	चौकीयां
chauki	चौकी
chaukhate	चौखते
chauguni	चौगुनी
chauda	चौदा
chaudah	चौदाह
chaudahavan	चौड़वान
chaudhavan	चौधवन
chaudhawan	चौधवान
chaupati	चौपती
chupaty	चुपत्य
chaupal	चौपल
chaurai	चौराई
chausinga	चौसिंगा
chausingha	चौसिंहा
chhagan	छागन
chhabi	छबी
chhalla	छल्ला
chhallaa	छल्ला
chhaviyaan	छवियां
chhaviyan	छावियां
chhavi	छावी
cheh	चेह
chhah	छाह
chehon	चेहों
chhahon	छाहों
chhai	छाई
chhagla	छाल्ला
chhajan	छजन
chhaati	छाटी
chhati	छटी
chhaapemaar	छापमेर
chhapemar	छप्मर
chheenk	छींक
chhink	छींक
chink	चिंक
chenkein	चेंकें
chhekein	छेकें
chhinke	छींके
chhinky	छींकी
chinke	चींके
chhudaane	छुड़ाने
chhudane	छुड़ने
chhupakar	छुपाकर
chhupkar	छुपकर
chhupkr	छुपकर
chhupata	छुपटा
chhupta	छुपटा
chhuptaa	छुपटा
chhura	छुड़ा
chhuraa	छुरा
chhuree	छुरी
chhuri	छुरी
chhure	छुरे
chhootane	छूटने
chhutane	छुटने
chhutne	छुटने
chheter	छेतर
chhetr	छेत्र
chhetter	छेत्र
chhetri	छेत्री
chhetthari	छेत्रही
chhetthri	छेत्री
chai	चाई
chhai	छाई
chhe	छे
jagaega	जगाएगा
jagayega	जगाएगा
jaghaega	जगाएगा
jgaayega	जगाएगा
jgayegaa	जगाएगा
jajaon	जजाओं
jajon	जाजों
jad	जाद
jadd	जद्द
jaddit	जद्दित
jadeite	जड़िते
jadet	जड़ेत
jadit	जड़ित
jadein	जड़ें
jaden	जाड़ेन
jatara	जतरा
jatra	जतरा
jataati	जताती
jatatee	जतती
jatati	जटती
janagananaa	जनगनाना
janaganna	जानगंना
jangadnaa	जांगदना
janganana	जांगनाना
janganna	जांगनाना
janajagran	जनजाग्रण
janjaagran	जनजाग्रण
janjagran	जनजागरण
january	जनुरी
janahaani	जनहानी
janahani	जनहानी
janhaani	जनहानी
janhani	जनहानी
jnhaani	जनहानी
jamaate	जमाते
jamaati	जमाती
jamati	जमाती
jamaaya	जमाया
jamaeya	जमाया
jamaya	जमाया
jamayaa	जम्या
jamuai	जमूई
jamuei	जमूई
jamui	जमूई
jai	जाई
jay	जय
jaidayal	जैदायल
jayadayal	जयादालय
jaydayal	जायदालय
jaibaan	जाबान
jaiban	जाबान
jaybaan	जायबान
jayalalita	जायललीता
jayalalitaa	जायललीता
jayalalithaa	जायलालीता
jaylalita	जायललीता
jarakh	जारख
zarakh	ज़ारख
jarda	जर्दा
jardaa	जर्दा
zarda	जर्दा
jalagati	जलागती
jalgati	जलगती
jalgti	जलगती
jalte	जलते
jalbharav	जलभराव
jalbhraav	जलभराव
jalbhrav	जलभर्व
jalvaayu	जलवायु
jalvayu	जलवायु
jalesar	जलेसर
jasmeet	जस्मीत
jasmit	जस्मित
jassee	जस्सी
jassi	जस्सी
jamaanaa	जमाना
jamana	जमाना
zamaanaa	जमाना
zamana	जमाना
jaljale	जल्जले
zalzale	जल्लाजे
zee	जी
jubaan	जुबान
juban	जुबान
zuban	जुबान
jaanch	जांच
jaaunch	जांच
janch	जांच
jaunch	जानच
jaagriti	जागृति
jagriti	जगरीति
jagruti	जागृति
jajamau	जजमाह
jajmau	जजमू
jajmauu	जजमू
jaat	जात
jat	जाट
jaatak	जातक
jatak	जटक
jaatakon	जातकों
jaatkon	जातकों
jatakon	जटकों
jaatiyon	जातियों
jatiyon	जातियों
jaankaaron	जानकारों
jaankaron	जानकरों
jankaron	जांकरों
jaanam	जानम
janam	जन्म
jaayke	जायके
jayke	जायके
jaawar	जावर
zawar	जवर
jing	जिंग
gin	गिन
jeen	जीन
jin	जिन
ginee	गिनी
jinee	जिनी
jini	जिनी
geneva	जेनेवा
jeneva	जेनेवा
jiniva	जिनिवा
gypsy	ज्पीसी
jimme	जिम्मे
jiya	जिया
gic	जीईसी
gr	गृ
gm	जीएम
gsm	जीएमएस
gtod	गोतोड
gtor	गृतोर
jeetod	जीतोद
jitod	जीतोद
jean	जेन
jeen	जीन
jin	जिन
jeenon	जीनों
jinon	जीनों
jeepney	जीपने
jipani	जीपानी
jeeyo	जियो
jio	जिओ
jiyo	जियो
jeera	जीरा
jira	जीरा
jeevant	जीवंत
jivant	जीवंत
jeevan	जीवन
jeewan	जीवन
jivan	जीवन
jiwan	जीवन
jeevanshaili	जीवनशीली
jivanshaili	जीवनशीली
jeevniyaan	जीवनियां
jivaniya	जीवनीय
jivaniyaan	जीवनियां
jivaniyan	जीवनियां
jeevraaj	जीव्राज
jivraj	जीव्राज
jua	जूआ
jue	जू
juye	जूए
jutee	जूती
juti	जूती
judaai	जुडाई
judae	जुड़ाई
judai	जुडाई
judaai	जुडाई
judai	जुडाई
junoon	जूनों
junun	जूनों
junooni	जूनूनी
jununi	जुनुनी
jubair	जुबैर
juber	जुबेर
zubair	जुबैर
juraab	जुराब
jurab	जुरब
julaahon	जुलाहों
julahon	जुलाहों
julmon	जुल्मों
zulmon	जुल्मों
jood	जूड़
jud	जुड़
junagadh	जूनागढ़
junagarh	जूनागढ़
junior	जूनियर
jealous	जिलूस
juloos	जुलूस
julus	जुलूस
jetha	जेठा
jenner	जेनर
generic	जेनरिक
jenrick	जेनरिक
generat	जनराट
generate	जनरेट
jenee	जीने
jenni	जेनी
jenny	जेनी
james	जेमेस
jeremy	जेरमी
gerome	जरोड़
jerome	जीरोम
jacks	जेक्स
jain	जाइन
gene	जेने
jaine	जाइने
jaino	जैनो
jainon	जैनों
jerry	जेरी
jasper	जसपेर
jogging	जोगिंग
johnson	जॉन्सन
jobs	जब्स
jockey	जोकेके
joki	जोकी
jokhim	जोखिम
joddta	जोड़ता
jodta	जोड़ता
jorhta	जोड़ता
jodiyon	जोड़ियों
jodo	जोड़ो
jaun	जौन
gyatavya	ज्ञातव्य
gyatvy	ज्ञात्व्य
gyapit	ज्ञापित
jyotiba	ज्योतिबा
joint	जॉइंट
jvar	ज्वर
jwar	ज्वर
jvaaron	ज्वारों
jvaron	ज्वारों
jwaron	ज्वारों
jewellers	ज्वेलर्स
jh	एभीए
jha	झा
jhalakti	झलकती
jhalkati	झलकती
jhalla	झाल्ला
jhankana	झंकना
jhankna	झांकना
jheel	झील
jhil	झिल
jheelon	झीलों
jhilon	झिलों
jhuthala	झुठला
jhuthla	झुठला
jhuthalane	झुठलाने
jhuthlane	झुठलाने
tankaar	टांकार
tankar	तंकर
takara	टकरा
takra	टकरा
takaraon	टकराओं
takravon	तकरवों
tapakti	तापक्ति
tapkati	तापकटी
time	टाइम
timer	टाइमर
taoo	ताउ
tau	ताऊ
tapoowo	टैवोबों
tapuon	तपूतों
tapuwo	तापुवों
tied	टीड
tired	टायर्ड
tyred	टायर्ड
tarch	टर्च
torch	टॉर्च
tik	टीक
teap	टीप
tip	टीप
tippanikar	टिप्पनिकार
tippnikar	टिप्पनिकार
tivolee	तिवोली
tivoli	तिवोली
teekamgarh	तीकार्घां
tikamgarh	तिकाग्महर
teekon	टीकों
tikon	टीकों
two	टू
tension	टेंशन
tenis	टेनिस
tennis	टेनिस
taste	तस्ते
test	टेस्ट
tasting	टैस्टिंग
testing	टेस्टिंग
tainin	तैनीन
tenin	टेनिन
tanish	तानीश
tennis	टेनिस
taboo	टाबू
taiboo	टैबू
taobao	टाबोह
tonic	टोनिक
tonga	टोंगा
toka	टोका
tuesday	ट्यसड़ी
tuning	ट्यूनिंग
tuberculosis	ट्यूलोज्सिसक
tuberkyulosis	तुर्बीकरिसकों
truck	ट्राक
trangistor	ट्रांजीशर
tranjister	ट्रांजीस्टर
transistor	ट्रांसिटर्स
transfer	ट्रांसफर
tribunal	त्रिबुल
tribunal	त्रिबुल
trubyunal	त्रुब्यूलन
truth	तृत
tuth	तूथ
traded	त्रेदेड़
trabal	ट्राबल
trebal	ट्रेबल
trouble	ट्रॉबल
traip	ट्रेप
trap	ट्रेप
trot	ट्रोट
trott	ट्रोट
thakkar	ठककर
thakkr	ठक्कर
thaharne	ठहराने
thahrane	ठहराने
theharne	ठहराने
thikane	ठिकाने
thumari	थुमरी
thumri	थुमरी
theinga	ठिंगा
thenga	ठेंगा
thengaa	ठिंगा
daglas	डागलस
douglas	डोल्सर
dabhara	दभारा
dabhra	दभरा
dabhoi	दभोई
dam	डैम
dum	दूम
darate	दरते
daratey	दरते
daravani	दरवानी
darawani	दरवानी
dravani	द्रवानी
down	डावन
daak	डक
dak	डक
daka	डका
dabi	दबी
dabolim	डबोलीम
dinosaur	दिनोसार
diaries	डायरिस
dit	दीत
depthiriya	दीप्थरिया
diphtheria	डीप्थेरिया
de	दे
dealership	डीलेरेशिप
dvc	डीसीवी
dubaana	दुबाना
dubana	दुबाना
dubona	दुबानो
dulne	दूलने
doonarpur	दूनरपुर
doongarpur	दुनगरपुर
dungarpur	दुनगरपुर
dungerpur	दुनगर्पुर
dubana	दुबाना
dubna	डुबना
dangerous	डांगरिस
daisy	दैसी
dazy	दज्य
deji	देजी
deputy	डेप्टी
davidson	डाविस्डों
devidson	डेविड्सन
davey	देवे
devi	देवी
dewey	देवे
destination	डेस्टिनेशन
datson	दातसों
datsun	दातसूं
daddy	दड़्य
dark	डार्क
dork	डोर्क
dose	डोसे
domenic	डोमेनिक
doranda	डोरेंड
dolane	डोलने
dolne	डोलने
dual	डुआल
duak	दुक
duke	डुके
drame	ड्रेम
dramen	ड्रेमन
drager	ड्रेजर
dredger	ड्रेजर
dreijer	ड्राजर
dhakaal	ढकाल
dhakal	ढकल
dhakkal	धक्कल
dhkal	ढकल
dhale	ढले
dhoondh	धूंध
dhundh	धूंध
dhoondhata	धूंधाता
dhundhata	धुंधता
dhundhta	धुंधता
dhoondhi	धुंधी
dhundhi	धुंधी
tanjavur	तंजावूर
thanjavur	थंजावूर
tantr	तंत्र
tantra	तंत्र
tantrikao	तंत्रिका
tantrikaon	तंत्रिकाओं
tantro	टांट्रो
tantron	टंट्रों
tagade	तगड़े
tagde	तगड़े
tadipaar	तड़ीपर
tadipar	तड़ीपर
tani	तानी
tapan	तपन
tarafa	तरफा
tarfa	टर्फा
tarabganj	तरबगंज
taras	तारस
taraash	ताराश
tarash	तारश
tarashay	ताराशय
tarashe	तरशे
tareeko	तारीको
tariko	तारीको
tark	तार्क
tarkvaad	तर्कवाद
tarkvad	तर्कवाद
tarkwaad	तर्कवाद
tarko	टरको
tarkon	तरकों
talabgaar	तलबगर
talabgar	तलबगर
talbagaar	तलबगर
talbagar	तलबगर
talawe	तलवे
talve	तलवे
talawon	तलावों
talvon	ताल्वों
tahakhana	तहखाना
tahkhaana	तहखाना
tahkhana	तहखाना
taantaa	टांटा
tanta	टांटा
tambe	टंबे
tanbe	टांबे
taaja	ताजा
taajaa	ताजा
taaza	ताजा
taja	ताजा
taza	ताजा
tansen	टैंसें
taapmaanon	तप्मानों
tapmano	तप्मानो
tapmanon	तप्मानों
taapti	तपती
tapti	तप्ती
tarabai	तरबाई
taseer	तसीर
tasir	तसीर
taahi	ताही
tahi	तही
tikone	टिकोने
tirupati	तिरुपति
tiwari	तिवारी
ti	टी
teer	टीयर
tir	ताइर
teeron	तीरों
tiron	तिरों
tirthatan	तीर्थतन
tungnath	टूंगनाथ
tughlaq	तुखलाक
tuglak	तुगलक
tughlakabad	तुलगाकाबाद
tughlaqabad	तुखलाजाबड़
tuglakabad	तुलगाकड़ाब
tugalaki	तुगलाकी
tugalki	तुगलकी
tuglaki	तुगलकी
tufail	टुफील
tejaji	तजाजी
teji	तेजी
tel	टेल
telon	टेलों
to	टू
toh	ताय
taul	टौल
tyohaar	त्योहार
tyohar	त्योहार
tyoihar	त्योहियार
tyauharon	त्याहोरों
tyoharon	त्योहरों
tyoiharon	त्योहारों
trijata	त्रिजता
trijta	त्रिजता
triya	त्रिया
tremasik	ट्रेमेकिक
trimasik	त्रिमासिक
tse	टेस
thaki	थाकी
thki	ठकी
tharti	थर्टी
thirty	थर्टी
thane	ठाने
thaanvi	ठानवी
thanvi	ठानवी
theateron	ठीटरों
theatron	ठीटरों
theaters	थैटर्स
theater	ठीटर
theatre	ठीतरे
theateron	ठीटरों
theatron	ठीटरों
thitron	ठीत्रों
theaters	थैटर्स
theatrs	थीटर्स
thiyeters	थीयेटर्स
thirake	ठिरके
thirke	थिरके
thief	ठीफ
then	ठें
theni	थीनी
thailee	थैली
thaili	थाली
thaile	थेले
dang	डांग
danga	दंगा
dangon	डांगों
dampati	दंपती
danpati	दाम्पति
dampatiyon	दंपतियों
dampattiyon	दम्पत्तियों
danptiyon	दंपतियों
dadreva	दाद्रेव
dadrewa	दादरेवा
damoh	डामोह
dardara	दरदरा
dardraa	दरदरा
durdhara	दूरधारा
darmiyaan	दरमियां
darmiyan	दरमियां
darjano	दरजानों
darjanon	दरजानों
darp	डर्प
darra	दररा
dalbadal	दलबदल
dalbadl	डालबडल
dali	डाली
dastaanaa	दस्ताना
dastana	दस्ताना
dastavej	दस्तावेज
dahan	दहान
dahal	दहल
da	दा
daakhil	दाख़िल
dakhil	दक्छिल
daakhile	दाखीले
dakhile	दखीले
daataa	दाता
data	डेटा
dadari	दादरी
daanshil	दांशील
danshil	दंशील
daabholkar	दाभोकालोस
dabholkar	दभोकारक
damale	दमले
damle	डमले
dayitv	दैयत्व
dayitva	दायित्व
dayitwa	दायित्व
dayitvon	डायटिवों
dayityon	डायिटियों
darul	दारुल
daav	दाव
daaw	दाव
dav	डीएवी
daw	डीएवी
daah	दाह
dah	दह
dikhla	दिखला
dikhlaa	दिखला
dikhaaiye	दिखाइए
dikhaiye	दिखाइए
dikhaai	दिखाई
dikhai	दिखाई
dikhayi	दिखाई
dikhaaee	दिखाई
dikhaai	दिखाई
dikhaain	दिखाईं
dikhaee	दिखाई
dikhai	दिखाई
dikhayin	दिखाइं
dikhai	दिखाई
dikhayi	दिखाई
dikhaai	दिखाई
dikhae	दिखाए
dikhai	दिखाई
dikhayi	दिखाई
dita	दिता
ditaa	दिता
dinaank	दिनांक
dinank	दीनंक
dirham	दीरहम
dilaaye	दिलाये
dilaye	दिलाए
deewani	दीवानी
diwani	दीवानी
divy	दिवी
divya	दिव्य
divyata	दिव्यता
divya	दिव्य
deepan	दीपन
deepn	डीपन
dipan	दीपन
deepsingh	डीप्संगि
dipsingh	डीप्शिंग
deepika	दीपिका
dipika	दीपिका
deeya	दीया
diya	दिया
dukaanon	दुकानों
dukanon	दुकानों
dukke	डकके
dukhan	दुखन
dukhit	दुखित
dukhiyon	दुखियों
dukhon	दुखों
dubhashiyon	दुभाशियों
durgun	दुर्गूं
durghatna	दुर्घटना
durghtna	दुर्घतना
duneerti	दुनिर्ती
durniti	दूर्निति
durbhiksh	दुरभिक्ष
duvidhaaen	दुविदाहान
duvidhaayein	दुविदायानी
duvidhaen	दुविदानी
duwaidhaayein	दुवाइदाएं
dune	दूने
doordarshan	दूरदर्शन
durdarshan	दूरदर्शन
dradh	दृध
dridh	दृध
dekhoge	देखोगे
denevaali	देनेवाली
denevali	देनेवाली
denewaali	देनेवाली
denewali	देनेवाली
deonar	डियोनर
devnaar	देवनार
devnar	देवनर
devaapur	देवापुर
devapur	देवपुर
devi	देवी
devisingh	डिवाइजंग
devisinh	डेविजिन
deshkaal	देशकाल
deshkal	देशकल
deshke	देशके
desai	देसाई
doge	दोगे
dvadash	द्वादश
dwaadas	द्वादास
dvivedi	द्वेविदी
dwivedi	ध्वेविदी
dhande	धंडे
dhandhe	धंधे
dhndhe	धंधे
dhandhon	धंधों
dhandon	धंडों
dhakelte	धकेलते
dhkelate	ढकेलते
dhatana	धताना
dhatna	धतना
dhankuber	धनकूबर
dhanadhany	धनाधांय
dhandhaanya	धनधान्य
dhandhany	धानधान्य
dhandhanya	धनधान्य
dhamkaataa	धमकता
dhamkata	धमकता
dhamm	धम्म
dhamma	धम्मा
dhammaa	धम्मा
dharmnath	धर्मानथ
dharmraj	धर्रमाज
dharmesh	धर्मेश
dhasmaanaa	धम्षाना
dhasmana	धड़माना
dhaak	ढाक
dhak	ढक
dhaaga	धागा
dhaagaa	धागा
dhaga	धागा
dhaatuein	धातुएं
dhaatuyein	धातुएं
dhtuen	धतें
dhaarak	धारक
dharak	धारक
dhaari	धारी
dhari	धारी
dhuan	धुण
dhunaai	धुनाएं
dhunai	धुनाए
dhuriya	धुरीय
dhuriyaa	धुरिया
dhuni	धुनि
dhairyavaan	धैर्यवान
dhairyawan	धैर्यवन
dhiryavan	धीर्यवन
dhiryawaan	धीर्यवन
dhokebaaj	धोकेबाज
dhokebaaz	धोकेबाज
dhokebaj	धोकेबाज
dhokebaz	धोकेबाज
dhokhebaaj	धोखेबाज
dhokhebaj	धोखेबाज
dhona	ढोना
dhonaa	ढोना
dhoraaji	धोराजी
dhoraji	धोराजी
dhoron	धोरों
dhyeyavaadi	ध्यायवादी
dhyeywadi	ध्यवेदी
dyeyvadi	दियवेदी
dhrupad	धर्पोद
drupad	द्रुपद
nandanvan	नंदन्वान
nadsa	नादसा
naksal	नकसाल
naxal	नैक्सल
naksalavaad	नक्सलावाद
naksalwaad	नक्सवालाद
naksalwad	नक्सवालद
naxalvaaad	नक्सतावाज
naxalwaad	नक्सतावाज
naksaliyon	नकसालियों
naxaliyon	नैक्सलियों
naksali	नकसाली
naxali	नैक्सली
nagaada	नगादा
nagaadaa	नगादा
nagaaraa	नागरा
nageene	नागीने
nagine	नागिने
najarandaaj	नजरअंदाज
najarandaaz	नज़रंदाज़
nazarandaaj	नज़रंदाज़
nazarandaaz	नज़रंदाज़
nazarandaz	नज़रंदाज़
najraane	नजराने
nazraane	नजराने
najariyon	नज़रियों
najriyon	नज़रियों
najron	नजरों
najeeb	नजीब
najib	नजीब
najibabaad	नजीबाबाद
najibabad	नजीबाबद
najeem	नाजीम
najim	नाज़िम
nazeem	नाजीम
nana	नाना
nanaa	नाना
nna	नना
nanhe	नन्हे
nanhein	नन्हें
nabj	नब्ज
nabja	नब्जा
nabz	नब्ज
namkeen	नमकीन
namkin	नमकीन
narnaari	नरनारी
narnari	नरनरी
narbhakshi	नरभक्षी
naram	नरम
narm	नर्म
narmi	नरमी
narsanhar	नरसंहर
narsanharon	नरसानहरों
november	नौमबद
navketan	नवकेतन
navjaagaran	नवजागरण
navjagran	नवजागरान
navdha	नवधा
navvadhoo	नवाधूवों
navvadhu	नववुधु
nava	नवा
navaa	नवा
navate	नवाते
navanagar	नवानगर
nawanagar	नवानगर
navya	नवया
naseem	नसीम
nasim	नासिम
nights	नाइट्स
nitrous	नाइटर्स
nineteez	निनीतिज
nineties	निनीटिस
ninties	निंटिस
nau	नौ
nauu	नौऊ
naakaam	नाकाम
nakam	नकम
naagrik	नागरिक
nagarik	नागरिक
nagrik	नागरिक
nagin	नागीन
nadep	नेडेप
nanak	नानक
nanavati	नानावती
napane	नापने
napne	नापने
napa	नापा
naam	नाम
naamdhari	नामधारी
namdhari	नामधारी
namankano	नमनकान
namankanon	नमनकानों
namavaliyon	नामावलियों
naamo	नामो
namo	नमो
nayak	नयक
naraji	नाराजी
naraingarh	नारांगरह
narayangadh	नारायनगढ़
narayangarh	नारायागनह
naasar	नासर
nahargadh	नहरागढ़
nahargarh	नहरागढ़
nikalegi	निकालेगी
nikalogi	निकलोगी
nikaalani	निकालनी
nikaalni	निकालनी
nikalani	निकालनी
nikalni	निकालनी
nicki	निकी
nicky	निकी
niki	निकी
niketan	निकेटन
nikhar	निखार
nikhari	निखारी
nigar	निगार
nigger	निगिर
nichala	निचाला
nichalaa	निचाला
nichla	निचला
nitiyon	नितियों
nitya	नित्य
nityaa	नित्या
nidhaan	निधान
nidhan	निधन
nipatara	निपटारा
niptaara	निपटारा
niptaaraa	निपटारा
niptara	निपटारा
niyanta	नियंता
niyantaa	नियंता
niya	निया
niyaa	निया
nirdeshika	निर्देशिका
nirdeshikaa	निर्देशिका
nirdhaarit	निर्धारित
nirdharit	निर्धरित
nirbaadh	निर्बाध
nirbadh	निर्बाध
niveshakartaa	निवेशकात्र
niveshkarta	निवेशकर्ता
niveshkartaa	निवेक्षत्र
nischal	निश्चल
nishchal	निश्चल
nishnaat	निश्नात
nishpaap	निष्पाप
nihalaani	निहालनी
nihlaani	निहलनी
nihlani	निहलनी
nihaalchand	निहालचंद
nihalchand	निहालचंद
neechaaee	नीचाई
nichaai	निचाई
neat	नीट
neet	नीत
neetiyon	नीतियों
nitiyon	नितियों
neelagaay	नीलागाय
nilgai	नीलगी
neelaabh	नीलाभ
nilaabh	नीलाभ
nilabh	नीलाभ
nuskhe	नुश्चे
noon	नून
nun	नन
noobiyaa	नूबिया
nubiya	नुबीया
nrityashaili	नृत्यस्लही
nrutyashaili	नृत्यसाहली
nrityon	नृत्यों
nrutyon	नृत्यों
neco	नेको
neko	नेको
nectar	नेक्टर
neg	नेग
nega	नेगा
networking	नेटवर्किंग
neto	नेटो
neta	नेटा
nemo	नेमो
nelsan	नेल्सन
nelson	नेल्सन
nations	नेशन्स
nehara	नेहरा
nehra	नेहरा
naino	नैनो
nano	नानो
naivedh	नाविद्ध
naivegh	नावीग
nevedya	नेवेदय
nominate	नोमिनेट
naukari	नौकरी
naukri	नौकरी
nokari	नोकरी
nokri	नोकरी
notes	नोटेस
nora	नोरा
nori	नॉरी
nauner	नौनर
nauvahan	नौवाहन
naushad	नौसाध
panchaang	पंचांग
panchang	पंचंग
punchang	पंचंग
punjab	पुंजाब
punjabiyon	पुंजाबियों
pantar	पंतर
panter	पेंटर
punter	पंटर
pakaayein	पकायें
pakaayen	पकायें
pakaen	पकाएं
pakayen	पकाएं
pakaude	पकौड़े
pakshapat	पक्षपात
pakshpaat	पक्षपात
pakshpat	पक्षपत
pagabadha	पगबाधा
pagbadha	पग्बदह
pagalaa	पगला
pagla	पागला
pachaataa	पचाता
pachata	पचाता
patakkar	पटककर
patkathaayein	पत्काताएं
patkathaein	पत्काताएं
patkathayen	पत्काताएं
patki	पटकी
pataraani	पतरानी
patrani	पत्रानी
patavaari	पतवारी
patwari	पतवारी
pataakshep	पत्काशपेष
patachep	पत्चेप
patakshep	पत्काशपेश
patiya	पटीय
patiyaa	पटीया
padaraunaa	पदारौणा
padrauna	पादरूना
padega	पदेगा
padegaa	पदेगा
padha	पढ़ा
padhaa	पढ़ा
padhaataa	पढ़ता
padhata	पढ़ता
patili	पटिली
padamawati	पदमावती
padmavati	पद्मावती
padmawati	पद्मावती
padadhikari	पदाधिकारी
panapnaa	पनपना
panpana	पनपना
panaamaa	पनमा
panama	पनमा
paneer	पनीर
pammi	पाममी
pammu	पाममू
pummi	पुममी
pummy	पुममी
pardesiyon	पारदेशियों
pardesi	परदेसी
parva	पर्वा
parvaa	परवा
parwa	परवा
parwaa	परवा
paraadheen	पराधीन
paraadhin	पराधीन
paradheen	पराधीन
paradhin	पराधीन
parikalpit	परिकलिपत
parimal	परिमाल
parishad	परिशाद
parishadiy	परिशादीय
parishadiya	परिशादिया
parishadon	परिशदों
parikhaen	परिखाएं
parikshaayein	परिक्षाएं
parikshaen	परीक्षाणी
parosane	परोसने
parosne	परोसने
parda	परदा
pardaa	परदा
purple	पुर्पल
palatne	पलतने
paltane	पलतने
palaari	पालारी
palari	पालरी
pale	पाले
palmonari	पलमोरण
pulmonary	पुलमारूनी
plus	प्लूस
pulse	पुलसे
pashtun	पश्तुन
pashtuun	पशुतुन
pahan	पाहन
pehan	पहन
pahantaa	पहनता
pahnata	पहनता
pehnate	पहनाते
pahanate	पहनते
pahante	पहनते
pehnate	पहनाते
pahnaakar	पहनाकर
pahnakar	पहनकर
pehnakar	पहनाकर
pahnaati	पहनाती
pahnati	पहनती
pehnati	पहनती
pahani	पहानी
pahni	पहनी
pehni	पहनी
pahno	पहनो
pehno	पहनो
pahla	पहला
pahlaa	पहला
pehla	पहला
paheliyaan	पहेलियां
paheliyan	पहेलियां
paheliyon	पहेलियों
pide	पीड़े
pied	पीड़
pythagoras	पिथागरासों
pythogaras	पिठारकर्ण
paakhandi	पाखंडी
pakhandi	पखंडी
paathshaalaayein	पाठशालाएं
pathshalayein	पथशालाएं
pathshalayen	पथशालाएं
paathyakram	पाठ्यकर्म
pathyakram	पाठ्यकर्म
pathykram	पाठ्यकर्म
paathyakramon	पाठ्यकर्मों
pathyakramon	पाठ्यकर्मों
pathykramon	पाठ्यकर्मों
population	पॉपुलेशन
pailot	पैलोट
pilot	पिलोट
pailoton	पैलोटों
piloton	पिलोटन
paarampariktaa	पारमप्रिकता
paramparikata	परम्पृक्तारा
paramparikta	परमप्रिकता
parnel	पर्नेल
parnell	परेनल
parleron	पारलेरों
parloron	पारलोरों
parlouron	पारलोरों
paarshad	पारशाद
parshad	परशाद
paarshadon	पर्शदों
parshadon	परशादों
parshdon	पर्शदों
policy	पॉलिसी
pinta	पिंटा
pintaa	पिंटा
piega	पीजा
piyegaa	पिएगा
pic	पीक
pick	पिक
pik	पिक
piki	पीकी
piky	पिक्य
picture	पिक्टूर
pigmentation	पिग्मेंटेशन
pigs	पिग्स
pichde	पीछड़े
pichhade	पीछड़े
pijja	पिज़्ज़ा
pizza	पिज़्ज़ा
pitaamaha	पितामहा
pitamah	पितामह
pipra	पिपरा
pipraa	पिपरा
pipli	पिपली
pearson	पिरसन
pierson	पिरसन
peary	पेरी
piyari	पियारी
pisaai	पिसाई
pisai	पिसाई
pihaani	पहानी
pihani	पहानी
pib	पिब
pr	पीआर
pml	पीएमएल
pmo	प्मी
pmch	पीछी
psv	पीएवबी
peaking	पीकिंग
picking	पिकिंग
peetne	पीटने
pitne	पिटने
pedia	पेडिया
pidiya	पीड़िया
pidiyaa	पीड़िया
peelepan	पीलेपन
pilepan	पीलेपन
pv	पीवी
pisa	पीसा
putla	पुत्ला
putlaa	पुत्ला
putaliyaan	पुतलियां
putliyan	पुतलियां
putaliyon	पुतलियों
putliyon	पुत्लियों
putali	पुतली
putli	पुत्ली
putale	पुतले
putle	पुतले
putin	पूटीन
putul	पुतुल
punargathan	पुनर्गतान
puna	पूना
puraane	पूराने
purane	पूराने
puru	पुरु
purjon	पूर्जों
purzon	पुर्जों
pulam	पुलम
pushkin	पुष्किन
pushkarana	पुष्करण
pushkarna	पुष्करण
pushkarnaa	पुष्करणा
pushp	पुष्प
pushpa	पुष्प
pushpa	पुष्प
pushpaa	पुष्प
pushpit	पुष्पित
pushpon	पुष्पों
poonjikaran	पूंजीकरण
punjikaran	पूंजीकरण
poojaapaath	पूपाजाठ
poojapath	पूजाप्थ
pujapath	पूजापथ
pooranpur	पूर्णपूर
puranpur	पुरानपुर
purvaabhaas	पूर्वाभास
purvaabhas	पूर्वाभास
purvabhaas	पूर्वाभास
purvabhas	पूर्वाभास
pendulam	पेंडुलम
pendulum	पेंडुल्म
peg	पेग
pages	पेग्स
pajej	पाजेज़
pace	पेस
pes	पेस
pastry	पास्ट्री
pangolin	पंगलीं
pengolin	पेंगलीन
packard	पैकर्ड
package	पैकेज
packageon	पैक्केजन
packagon	पैकगों
packajon	पककादों
paim	पैम
pam	पाम
paratrooper	परतरूप्र
peratrupers	पैराट्रॉप्स
paranormal	परामोरान
peranormal	पैरानोरामल
paraffin	परफिन
parafin	पराफीन
perafin	पैरफीन
parabola	पराबोला
perabola	परेबला
polimer	पोलिमेर
polymer	पॉलिमर
polishing	पॉलिशिंग
pokar	पोकर
poker	पॉकर
polish	पालिश
poshit	पोषित
posta	पोस्ता
pau	पाऊ
pyade	प्यादे
prakriya	प्रकरिया
prakshepak	प्रक्षेपक
pratigya	प्रतिग्य
prtigyaa	प्रतिग्य
pratibhutiyan	प्रतिभूतियां
pratiyon	प्रतियों
prativaad	प्रतिवाद
prativad	प्रतिवाद
prativadi	प्रतिवादी
pratishat	प्रतिशत
praneet	प्रणीत
pranit	प्रणित
prapaat	प्रपात
prapat	प्रपात
prapaaton	प्रपातों
prapaton	प्रपतों
prabodhini	प्रबोधिनी
prayaasrat	प्रयासर्त
prayasarat	प्रयासारत
pradarshan	प्रदर्शन
prardashan	प्रदर्शन
pravati	प्रवाति
pravatti	प्रवत्ति
prashaasanik	प्रशानसिक
prashasanik	प्रशासनिक
prashasnik	प्रशासनिक
prashaasanon	प्रशासनों
prashansanon	प्रशंसनों
prashasanon	प्रशासनों
prashikshu	प्रशिक्ष
prastaavon	प्रस्तावों
prastavon	प्रस्तावों
prahlaad	प्रहलाद
prahlad	प्रहालड
prahasan	प्रशान
prahsan	प्रशान
prahaarak	प्रहारक
praharak	प्रहारक
prahad	प्राध
prahlad	प्रहालड
privacy	प्राविक्टी
praakkathan	प्रकक्थन
prakkathan	प्रक्काटन
praan	प्राण
pran	प्राण
pranon	प्रणों
prathamik	प्रथामिक
prathmik	प्रथमिक
praathmikata	प्राम्तिकता
prathmikta	प्राथमिकता
prathmiki	प्रथमिकि
pradhyapakon	प्रध्यापकों
prapt	प्राप्त
prapta	प्रपत्ता
prapti	प्रप्ति
praroop	प्ररूपुर
prarup	प्ररूप
priyamani	प्रियमनी
proof	प्रूफ
pruf	प्रफू
prekshakon	प्रेक्षकों
prem	प्रेम
premlata	प्रेमलाटा
prema	प्रेमा
premi	प्रेमी
profit	प्रोफाइट
processing	प्रोसेसिंग
programers	प्रोग्रामर्स
programmers	प्रोग्रामेर्ड
programs	प्रोग्राम्स
proto	प्रोतो
propellant	प्रॉपेलेंट
propellent	प्रॉपलेंट
praudh	प्रौढ़
proud	प्रौड
plan	प्लान
plane	प्लाने
fund	फंड
funda	फुंडा
funding	फुंडिंग
fandon	फांडों
fagua	फगुआ
fatane	फताने
phatane	फटने
phatne	फटने
fadfadata	फड़तबता
phadphadata	फड़फेड़ता
fatehgadh	फतेहगढ़
fatehgarh	फतेहगढ़
fabti	फाबती
phabti	फब्ती
farse	फरसे
pharase	फरासे
pharse	फरसे
farheen	फरहीन
farhin	फरहीन
farth	फर्थ
ferth	फर्थ
pharth	फर्थ
farmion	फारमियन
fermion	फेरमियन
firmian	फर्मियां
farookhabad	फारूकबाद
farrukhabad	फरुर्खाबाद
farukhabad	फारूकबाद
farookhnagar	फारूगनगार
farrukhnagar	फर्रुधनगर
farukhnagar	फारुधलांग
falata	फलता
falta	फालता
phalata	फलता
falne	फालने
phalne	फालने
falitarth	फलीतार्थ
phalitartha	फलीतर्थ
falibhoot	फलीभूत
falibhut	फलीभूत
phalibhoot	फलिभूत
favvara	फाववरा
fawaara	फवारा
favvare	फाववरे
fawaare	फावरे
favvaron	फाववरों
fawaaron	फावरों
faisala	फैसला
faisla	फैसला
follow	फोलोव
faansi	फांसी
fansi	फांसी
fatama	फटमा
fatma	फट्मा
faaf	फाफ
phaaph	फाफ
farsi	फरसी
forcee	फोर्सी
farm	फार्म
form	फॉर्म
farmic	फार्मिक
formic	फॉर्मिक
formulae	फॉर्मूलिया
formule	फॉर्मूल
formuley	फॉर्मूली
pharmacy	फार्मेसी
pharma	फर्मा
pharmon	फार्मों
farms	फार्म्स
finger	फिंगर
fikra	फिक्र
physician	पाइसिकन
firti	फर्ती
fisla	फिसला
fislaa	फिसला
feeder	फीडर
fulaaye	फुलाए
fulae	फुलाई
fulay	फुलाय
furti	फुरती
phurti	फुरती
fus	फूस
phoos	फूस
phus	फूस
feka	फेका
fefada	फफेडा
fefda	फेफ्डा
facial	फैसियल
fact	फैक्ट
federal	फेडरल
failkar	फैलकर
failaaiye	फैलाएय
failaea	फैलाई
failaiya	फैलाइया
failaiye	फैलाइए
failegi	फैलेगी
font	फॉन्ट
fogat	फोगट
phogat	फोगट
fod	फोड
phod	फोड
foda	फोडा
fodaa	फोड़ा
phoda	फोडा
fode	फोड़े
phode	फोड़े
fodo	फ़ोडो
fodon	फोड़ों
phodo	फोडो
fortis	फॉर्टिस
fusion	फ्सूयन
fuji	फुजी
fyuji	फिब्यी
francisca	फ्रांसिक्स
franciska	फ्रेंसिकास
fransiska	फ्रांसिक्स
francisco	फ्रांसिक्स
francisko	फ्रेंसिक्क
fransisko	फ्रांसिक्स
fringe	फ्रिंज
friendship	फ्रेंडशिप
frost	फ्रॉस्ट
flin	फ्लीन
flynn	फ्लेन
flesh	फ्लैश
bang	बंग
bung	बंग
bangbandhu	बांगबंध
bangbhang	बांगभंग
bangash	बंगाश
bangsh	बांगश
bantane	बांटने
bantne	बैंटने
bandhati	बंधाती
bandhti	बंधती
bandhan	बंधन
bandhuon	बंधुओं
bamba	बांबा
mumba	मुंबा
bakaayon	बकायों
bakayon	बकायों
bakaul	बकौल
bakoul	बकौल
baksa	बक्सा
baksi	बक्सी
bakse	बक्से
bakhshane	बख़ाशने
bakhshne	बख्षेने
bagad	बागड़
bagd	बग्द
bageechi	बगीची
bagichi	बगीची
bachat	बचात
bachati	बचाती
bachti	बच्ती
bajana	बजाना
bajrangi	बजरंगी
bajaj	बजाज
batalvi	बतलवी
badhachadhakar	बढ़चाधकार
badata	बदता
badhaataa	बढ़ता
badhata	बढ़ता
badhaati	बढ़ाती
badhati	बढ़ती
badhayi	बढ़ायी
badhav	बढ़ाव
badhotari	बढ़ौत्री
badhotri	बढ़तीरी
batlaae	बतलाई
batlaaye	बतलाये
batlae	बतलाई
batlaye	बतलाये
batlaakar	बतलाकर
batlakar	बतलाकर
badlapur	बदलापुर
badali	बदली
badli	बदली
badam	बदम
banva	बनवा
banvaa	बनवा
banaam	बनाम
banam	बन्म
bnaam	बनाम
baniya	बानिया
banu	बानू
barpaayaa	बरपाया
barpaya	बरपाया
barsa	बरसा
barsaata	बरसाता
barsaataa	बरसाता
barsata	बरसता
barhad	बराध
baraat	बारात
barat	बरात
braat	भ्रात
baraamad	बरामद
baramad	बरामद
bramad	ब्रमाड़
baramade	बरामदे
baramde	बरामदे
bare	बारे
birth	बिर्थ
baljeet	बालजीत
baljit	बालजीत
ballabh	बल्लभ
balla	बल्ला
balli	बल्ली
basava	बसवा
bastiyon	बस्तियों
bahroopiya	बहरूपिया
bahrupiya	बहरुपिया
bahamaas	बहामास
bahamas	बहामस
bahaav	बहाव
bahav	बहाव
bhav	भाव
bahavalpur	बहावलपुर
bahawalpur	बहावलपुर
bahuchara	बहुचारा
banthia	बांठी
banthiya	बंठाई
bandhate	बंधाते
bandhte	बंधाते
banbi	बांबी
bombi	बोंबी
bounceron	बौनसोर
bowling	बोलिंग
baku	बाकू
bakuu	बाकू
baag	बाग
bag	बग
bagh	बाघ
bagabani	बागबनी
bagbani	बागबनी
bagali	बागली
bagli	बागली
baagiyon	बागियों
bagiyon	बागियों
baago	बागो
bago	बागो
baji	बजी
bazi	बाजी
bajaru	बाजरू
bazaru	बाजरू
bajuon	बाजूओं
badh	बढ़
badha	बढ़ा
baadhaaon	बाधाओं
baadhaon	बाधाओं
badhaaon	बढ़ाओं
badhaon	बढ़ाओं
baadhit	बाधित
badhit	बाधित
baani	बानी
bani	बनी
baapa	बापा
baapaa	बापा
bapa	बापा
bapaa	बापा
baabat	बाबत
babat	बबात
babt	बब्ट
bayern	बैयर
byrun	ब्यूर्ण
barah	बारह
baarahamaasee	बारहमासी
barahamasi	बराहमासी
barahmasi	बराहमासी
barahsinga	बार्शाइनक
barasingha	बरासिंहा
bala	बाला
baalti	बालती
balti	बालती
balty	बेली
baldvin	बालदवीं
baldwin	बालदवीं
bavaji	बावजी
bavji	बावजी
baawaraa	बावरा
bavra	बावरा
bawara	बावरा
baahulya	बाहुल्य
bahuly	बहुल्य
bahulya	बहुल्य
box	बॉक्स
bikherati	बिखेरती
bikherti	बिखरीती
biggest	बिग्गेस्ट
bichhua	बिछुआ
bichhuaa	बिछुआ
biji	बीजी
busy	बस्य
buzy	बुज्य
bipin	बिपिन
bilae	बिलाई
bilai	बिलाई
billa	बिल्ला
billaa	बिल्ला
bilhaur	बिलहर
bisva	बिस्वा
biswa	बिसवा
bag	बग
bikaner	बिकनेर
bikaneri	बिकनेरी
bk	बीकी
beejak	बीजक
bijak	बीजक
beef	बेफ
beem	बीम
bim	बीम
beemon	बीमों
bimon	बीमों
beerganj	बीर्गंज
birganj	बिरगंज
beesavaan	बीसवां
bisavan	बिसवन
bisawan	बिसवन
beast	बिस्ट
budvig	बुड्विग
budwig	बुडविग
bull	बॉल
bulaao	बुलाओ
bulao	बुलाओ
bule	बुले
bulletin	बुलेलीन
brijesh	ब्रेजेश
benvar	बेनवर
benwar	बेनवर
beaulad	बुलाद
bekaaboo	बेकाबू
bekabu	बेकबू
bechakar	बेचकर
bechkar	बेचकर
bechate	बेचते
bechte	बेचते
bediyan	बेडियां
bethanal	बेथनल
bethnal	बेथनल
benis	बेनिस
belacha	बेलचा
belcha	बेल्चा
belinda	बेलिंडा
bevkufana	बेफकुवाना
bewakoofaanaa	बेवकूपाला
bewkufana	बेवुकुफाना
besahaaraa	बेसाहारा
besahara	बेसहरा
basin	बसीन
besin	बेसिन
basil	बेसील
besil	बेसिल
bandage	बंदागे
bandej	बंदेज
baithantey	बैठांते
baithate	बैठाटे
baitool	बैटूल
baitul	बैटल
betul	बेटल
baini	बैनी
beni	बेनी
bairakpur	बैराकपुर
barrackpore	बर्रकपिर
baila	बैला
bella	बेल्ला
ballistic	बैल्लिसिटिक
bells	बेल्स
bostan	बोस्टन
bosten	बॉस्टन
boston	बोस्टन
bokaro	बोकरो
bodara	बोदरा
bodra	बोदरा
bodraa	बोदरा
bona	बोना
borkar	बोरकर
borivali	बोरिवाली
boriwali	बोरिवाली
born	बॉर्न
bolane	बोलने
boliae	बोलिया
boliy	बोलीय
boliye	बोलीय
bosaan	बोसन
bosan	बोसन
bauni	बौनी
bouni	बौनी
byaawa	ब्यावा
byavar	ब्यावर
brajesh	ब्रेजेश
brijesh	ब्रेजेश
brahmalin	ब्रह्मलीन
brahmleen	ब्रह्मलीन
brahmlin	ब्रह्मलीन
bravo	ब्रेवो
brigatn	ब्रिगेंट
brighton	ब्रहोटन
brigton	ब्रिग्टन
brigadier	ब्रिगाइड
britain	ब्रिटें
breed	ब्रीड
brock	ब्रॉक
brok	ब्रोक
broke	ब्रॉक
brocken	ब्रॉकें
broken	ब्रोकें
blosam	ब्लोसम
blossom	ब्लोसम
bhagaane	भगाने
bhagane	भागने
bhadakaaya	भड़काया
bhadakaya	भड़काया
bhadkaayaa	भड़काया
bhadkaya	भड़काया
bharakaaya	भड़काया
bharakaya	भड़काया
bhabhoot	भभूत
bhabhut	भाभूत
bhay	भाय
bhaya	भाया
bhayo	भायो
bharatanatyam	भरातनंप्य
bharatnatyam	भारतंतयम
bhartnatyam	भर्तनात्यम
bharate	भराते
bharte	भरते
bharani	भरानी
bharni	भरणी
bharane	भराने
bharne	भरने
bhara	भरा
bhavishya	भविष्य
bhaate	भाते
bhate	भाटे
bhanu	भानु
bhabar	भाबर
bhareeye	भरीय
bhariy	भरीय
bhavanaon	भवनाओं
bhavnaon	भावनाओं
bhaskar	भसकर
bheed	भीड
bheera	भीरा
bhira	भीरा
bheesham	भीस्म
bhisham	भिष्म
bhishm	भीष्म
bhugat	भूगत
bhugata	भुगता
bhugta	भुगता
bhutto	भूटतों
bhumi	भूमि
bhurbhura	भुरभुरा
bhookh	भूख
bhukh	भूख
bhookhi	भूखी
bhukhi	भूखी
bhoogol	भूगोल
bhugol	भूगोल
bhootal	भूतल
bhutal	भूतल
bhoopsingh	भूपिंग्ष
bhupsingh	भूपिंग्ष
bhumi	भूमि
bhumika	भूमिका
bhulata	भूलता
bhulataa	भूलता
bhulta	भूलता
bhula	भुला
bhulaa	भुला
bhooli	भूली
bhuli	भूली
bhulo	भूलो
bhulon	भूलों
bhusi	भूसी
bhooswaami	भूस्वामी
bhusvami	भूस्वामी
bhuswami	भूस्वामी
bhengapan	भेंगापन
bhairavnath	भैरावनाथ
bhairo	भैरो
bhogatey	भोगते
bhogte	भोगते
bhola	भोला
bholi	भोली
bholu	भोलू
bhaunho	भौंधों
bhaunhon	भौनहों
bhoonhon	भूनोहों
bhraant	भ्रंत
bhrant	भ्रंत
brant	ब्रंट
bhraanti	भ्रणती
bhranti	भ्रणती
branti	ब्रंटी
bhraantiyan	भ्राणतीय
bhrantiyan	भ्रांतियां
bhraantiyon	भ्राणितियों
bhrantiyon	भ्रांतियों
mangesh	मंगेश
manch	मैंच
manchit	मानचित
mancheeye	मानचिये
manchiy	मंचिय
manchiya	मंछिया
manchon	मंचों
manjil	मांजिल
manzil	मांजील
manjila	मांजीला
manzila	मनजीला
manjilein	मांजीलें
manjilen	मांजीलें
manzilein	मांझिलें
manto	मांटो
mantriyon	मंत्रियों
makrani	मकरानी
maksad	मकसद
makhdumpur	मखमूदपुर
machaaye	मचाए
machae	मचाई
machaye	मचाये
machaanon	मचानों
machanno	मचनानो
machano	माचनों
machanon	मचानों
madaura	मदौरा
madhuara	मधुरा
madhura	मधुरा
manipal	मनिपाल
matpatron	मत्तप्रों
matthe	मैथे
matsyavatar	मत्स्यवस्ताओं
matsyavtar	मत्सीयवर्ता
masyendranath	मस्मीनाद्रेच
matsyendranath	मातस्वैंशन
madhupur	मधुपुर
manmarji	मनमर्जी
manae	मनाई
manaye	मनाये
mnaey	मनाए
mam	माम
mum	मुम
maryokar	मार्यकर
mayorka	मयूरका
mayorkaa	मैयूग्ता
mardaani	मर्दानी
mardani	मर्दानी
marmar	मरमार
murmur	मूरमुर
maratha	मर्ठा
marathi	मराठी
marji	मर्जी
mardanagi	मर्दनागी
mardangi	मरदंगी
mardo	मार्डो
mardon	मरदों
maryaadaa	मर्यदा
maryada	मर्यदा
maryaadaaon	मर्यादान
maryadaon	मर्यदाओं
malaga	मालागा
malaar	मलार
malar	मलार
mashrak	मश्रक
masaaledaar	मसालेदार
masaledaar	मासलेडार
masaledar	मसलेदार
masoor	मसूर
masur	मसूर
masse	मसेस
mahakane	महकने
mahakne	महकने
mahkane	महकने
mehkane	महकाने
mahalon	महलों
mahlon	महलों
mahagranth	महाग्रंथ
mhagranth	महाग्रंथ
mahajan	महाजन
mhajan	महाजन
mahathir	महाथिर
mhathir	महातिहर
mahanatam	महानतम
mahantam	महांतम
mhantam	महांतम
mahanideshak	महानिदेशक
mahanirdeshak	महानेद्रेशक
mhanideshak	महानिदेशक
mahapauron	महापौरों
mhapauron	महापुरों
mahapran	महाप्रण
mhapran	महापरण
mahamantr	महामंत्र
mahamantra	महामंत्र
mhamantra	महामंत्र
maharaja	महाराजा
mahavigyan	महाविज्ञान
mhavidyan	महाविद्यान
mahavidya	महाविद्या
mhavidya	महाविद्या
mahavishnu	महाविशीनु
mahasingh	महासिंघ
mahasinh	महासिध
mahipal	महिपाल
mahin	महिन
mahinon	महिनों
maang	मांग
mang	मांग
mangani	मंगानी
mangni	मंगनी
maanga	मांगा
manga	मंगा
maangi	मांगी
mangi	मंगी
maange	मांगे
mange	मांगे
mango	मंगों
maori	मारी
maajin	माजिन
majin	माजिन
mathe	माथे
mathey	मैथे
maap	माप
map	मैप
mop	मॉप
mamooli	ममूली
mamuli	ममुली
mame	मामे
maarvaad	मारवाद
marvad	मारवाद
marwar	मरवर
maariya	मारिया
mariya	मरिया
maariyo	मारियो
mario	मरियो
mariyo	मरियो
martha	मर्था
maalish	मालीश
malish	मालिश
mave	मावे
mavey	मेवे
maas	मास
mas	मास
mass	मस
maason	मासों
mason	मसों
mitaao	मिटा
mitao	मिटा
mithaai	मीठाई
mithai	मीठाई
media	मेडिया
mithila	मिथिला
mithilanchal	मिथलेंचल
mithya	मिठ्या
mimicry	मिमिक्री
milkiyat	मिलकियत
misha	मिशा
mungeri	मुंगरी
mundva	मुंडवा
mundwa	मूंडवा
munshiganj	मुशनिग्रज
mukarte	मुकरते
mukartey	मुकारते
mukhopadhyaya	मुखायोष्म्या
mukhyopadhyaay	मुख्योपयधय
mukhyamantri	मुख्मन्तरी
munaf	मुनाफ
munafa	मुनाफा
munnu	मुनुण
mufalisi	मुफालिसी
muflisi	मुफलिसि
mubarakpur	मुबरूकपुर
mubarkpur	मुबर्कपुर
murjha	मुरझा
multae	मुलताई
multai	मुलताई
mushahid	मुशाहिद
muhavare	मुहावरे
muhavre	मुहावरे
mooth	मूथ
muth	मुथ
mood	मूड़
mud	मुड़
moodi	मूडी
moody	मूद्य
mool	मूल
mul	मूल
moolchand	मूलचंद
mulchand	मूलचंद
moolar	मूलर
mular	मूलर
muller	म्लुलर
moolon	मूलों
mulon	मूलों
maxico	मैक्सिको
mexico	मैक्सिको
mega	मेगा
megapixal	मैगापिसल्क
megapixel	मैग्पिस्टल
mejbaan	मेजबन
mejban	मेजबन
mezbaan	मेजबान
mejabani	मजाबानी
mejbaani	मेजबनी
mejbani	मजबनी
mezabani	मजाबानी
mejbaan	मेजबन
mejban	मेजबन
mezbaan	मेजबान
mejbaani	मेजबनी
mejbani	मजबनी
mezbaani	मजबानी
mate	मेट
met	मेट
mates	मेट्स
medical	मेडिकल
methanol	मेथनोल
menu	मेनु
mem	मेम
melaghaat	मेलाघात
melghat	मेलघत
melaanin	मेलानिन
melanin	मेलनीन
melaani	मेलानी
melani	मेलनी
maheman	महामन
mehamaan	मेहमान
mehaman	मेहमान
mehmaan	मेहमान
mehman	मेहम
meharaam	मेहराम
mehram	मेहरम
macbook	मैकबुक
matix	मेटिक्स
matrix	मेट्रिक्स
mad	मैड
made	मेड
maid	मैड
maddy	मद्ध
maidi	मैदी
main	मैं
man	मन
men	मेन
mainan	मैनन
menon	मेनों
manner	मन्रेर
maina	मैना
maine	मैने
marrej	मरेज
marriage	मैरिज
merraige	मेरेज
maisachusets	मैसाउक्शस्ट
massachusetts	मैसाउचेस्टेक्ट
maisor	मैसोर
maisore	मैसोर
mysore	मैसोर
mod	मोड़
mode	मोड़
modern	मोडर्न
module	मोडले
modules	मोडल्स
modyuls	मोडियल्स
mauritious	मौरीशस
mauritius	मॉरीशस
mogali	मोगली
mowgli	मोगली
motive	मोटिवे
mol	मॉल
mold	मॉल्ड
moshe	मोशे
mosad	मोसाड़
mohana	मोहना
mohani	मोहनी
mohini	मोहिनी
mohim	मोहिम
maukon	मौकों
mauma	मौमा
maurya	मौर्य
morya	मोरया
maurya	मौर्य
mauryon	मौर्यों
moryon	मॉरियन
maulaviyon	मौलवियों
maulvidon	मौलविद
maulviyon	मौलवियों
maule	मॉले
mauley	मॉले
mausa	मौसा
yatn	यतन
yatna	यातना
yada	यादा
yda	याड़
yaduvansh	यादुवांश
yaduwansh	यादुवांश
jerusalem	जेरूसलम
yarooshaleim	यारूच्रिम
yarushalem	यारुश्लम
yashpaal	यशपाल
yashpal	यशपल
yaatna	यातना
yatna	यातना
yaatanaon	यातानाओं
yatnaon	यातनाओं
yarayan	यायरण
yatraein	यतार्एं
yatraen	यतार्णी
yaariyan	यारियां
yariyan	यारियां
yaari	यारी
yari	यारी
yugam	युगम
yugm	युग्म
yuddhrat	युद्धरत
yudhrat	युद्धरत
ukrainian	उक्रेयनियां
ukranian	उक्रानियां
jerusalem	जेरूसलम
yorker	योरकर
yojanaein	योजनाएं
yojanaen	योजनाएं
yojanaye	योजनाये
rangate	रंगते
rangte	रंगते
rangkata	रंगकता
ranjkatha	रंजकथा
ranjkta	रंजकता
raees	रायस
rais	राइस
raktaabh	रक्तभ
raktabh	रक्तभ
rakhna	रखना
raghupati	रघुपति
raghuram	रघुरम
registerd	रिजिस्टर्ड
registered	रिजर्सिट्ड
ratanpur	रतनपुर
runners	रूनर्स
rayan	रायन
ryan	रायन
ralhan	रालहण
ravish	रवीश
ravael	रवेल
ravel	रेवल
rawail	रवैल
rasad	रसड़
rasaayanik	रसायानिक
rasaayanika	रसायानिका
rasayanika	रसायानिका
rasyanik	रास्यनिक
rasaayanon	रसायानों
rasayanon	रसायनों
rahamat	रहमत
rahmat	रहमत
rhamat	रहमत
rahenge	रहेंगे
rahegi	रहेगी
rounder	रूंदर
raak	राक
rak	रक
raakhe	राखे
rakhe	रखे
raagon	रागों
ragon	रगों
raghavan	रघवान
raaj	राज
raj	राज
rajkot	राजकोट
rajtantra	राजतंत्र
raajneetikaran	राजनीताकरण
rajneetikaran	राजनीतिकर्ण
rajnitikaran	राजनीताकरण
rajma	राजमा
rajman	राजमान
raajasva	राजस्वा
rajasva	राजस्वा
raaji	राजी
raji	राजी
rajinaama	राजीनमा
rajinama	राजीनमा
raajon	राजों
rajon	राजों
rana	राना
raatrichar	रातरीचार
ratrichar	रातरीचार
raadhe	राधे
radhe	राढ़े
ranapur	रानापुर
rabin	रबीन
robin	रॉबिन
rabha	राभा
ramkot	रामकोट
ramkote	रामकोट
ramtek	रामतेक
rampur	रामपुर
rambharose	रामभारोस
rambharosey	रामभारेशी
ramraj	रामराज
raalod	रालोद
ralaud	रालौद
ralod	रालोद
ravaley	रावले
ravle	रावले
rasayanik	रसायानिक
racreation	रैस्टाइन
recreation	रिक्रीशन
rig	राइग
riggs	राइग्स
rigs	राइग्स
richual	रिचुल
ritual	ऋतुल
reduction	रेडेक्शन
ripan	रिपन
ripon	रिपों
ria	रिया
riya	रिया
rishte	रिश्ते
rishtey	रिश्ते
risane	रिसने
risaney	रिसने
risne	रिशने
rihana	रिहाना
rihanna	रिहनना
regal	रेगल
rigal	रिगल
reasonal	रियोनेकर
regional	रेजिनाल
retreate	रेट्राइट
retweet	रितवीत
reeta	रीता
rita	रीता
rukate	रुकते
rukte	रुकते
ruktey	रुकते
rugan	रूग्ण
rugna	रूग्ण
ruganta	रूगानता
rugnata	रूग्नता
rojvelt	रॉजेवेल्ट
roojwelt	रूजवेल्ट
roosevelt	रूज़ेवल्ट
rodolph	रोडोलफ्री
rudolf	रूडोल्फ
rudolph	रूडोल्फ
roopesh	रुपेश
rupesh	रूपेश
ruby	रूबी
roomani	रूमानी
rumani	रूमानी
rukavaton	रुकावटों
root	रुट
route	रुते
rooting	रूटिंग
routine	रोटिन
routing	रुटिंग
roots	रुट्स
routes	रूटस
roopak	रुपक
rupak	रुपक
roopi	रुपी
rupi	रुपी
rantle	रंतले
rental	रेंटल
registan	रेजिस्टन
registani	रेजिस्टानी
reja	रेजा
reza	रेजा
rate	रैट
rate	रैट
ret	रेट
refaeli	रेफाली
refeli	रेफली
reshe	रेशे
reshey	रेशे
race	रास
rese	रेस
racer	रेसर
recer	रेसर
racing	रासिंग
reson	रेसों
rehaana	रेहाना
rehana	रहना
racketeer	राकेटिर
racketier	राकेटियर
rectare	रेक्टर
radical	राडिकल
raidical	राडिएकल
raith	राथ
rapping	रैपिंग
wrapping	रैपरिंग
robertsan	रॉबर्टन्स
robertson	रॉबर्टन्स
robinson	रोबिंसों
royals	रोयेल्स
rojlin	रोजलीन
rozlyn	रोजलिन
rotation	रोटेशन
rodrigo	रोडरोगों
ronaldo	रोनाल्ड
ronit	रोनिट
roni	रोनी
ropane	रोपने
ropaney	रोपने
ropne	रोपने
robin	रॉबिन
roya	रोया
rollers	रॉलर्स
rovan	रोवन
rowan	रौने
rosario	रोसरेश
rosariyo	रोसरोयि
raubadaar	रौबदर
raubadar	रौबदर
raubdar	रौबदर
landara	लंदरा
langada	लंगाड़ा
langda	लंगदा
langar	लंगर
langaron	लंगरों
langron	लंगरों
lambi	लांबी
lakeer	लकीर
lakir	लकीर
lakiron	लकरीण
lakme	लकमे
lakshmidhar	लक्ष्मीधार
lakshmighar	लक्ष्मीगार
lakshy	लक्ष्य
lakshya	लक्ष्य
lakshyon	लक्ष्यों
lux	लक्स
laksar	लक्षर
luxor	लाकोर
lakhkhi	लक्खी
lagna	लगना
laganewale	लगनेवाले
lagnevaaley	लगनेवालाय
lagnewale	लगनेवाले
lagega	लगेगा
lajjalu	लजजुल
latkate	लटकते
ladki	लड़की
ladate	लड़ते
ladte	लड़ते
ladaai	लड़ाई
ladai	लड़ाई
ladaaiyon	लड़ाईयों
ladaeyon	लड़ाइयों
ladaiyon	लड़ाइयों
lapetane	लपेटने
lapetne	लपेटने
labada	लबड़ा
lbada	लबड़ा
labdh	लब्छ
lbdh	लीब्च
lalak	लालक
lalkarata	लालकरता
lalkarta	लालकर्टा
lalla	लल्ला
lavasa	लवासा
lovasa	लोवसा
lassi	लासी
lahanaa	लहना
lahna	लहना
lehna	लहाना
lahraee	लहराई
lahrai	लहराई
lehrayi	लहरायी
lahalhati	लहहालति
lahlahaati	लहलहाती
lahlahati	लहलहाती
lahsun	लाहसून
lasoon	लासून
lanchar	लंचर
launcher	लौंचेर
lycopene	लाइकपनी
lime	लिमे
lives	लिवेस
live	लिवे
laegi	लागी
lagataar	लगातार
lagatar	लगातर
laata	लाटा
lata	लाटा
laati	लाटी
lati	लाटी
layega	लाएगा
lalpur	लालपुर
las	लास
last	लास्ट
lindbhed	लिंडबिड
lingbhed	लिंगबेड
lindan	लिंडन
lindn	लिंडन
lindon	लिंडों
likhakar	लिखकर
likhkar	लिखकर
ligar	लिगर
liger	लाइगर
liberation	लिबरेशन
libration	लिब्रेशन
liberation	लिबरेशन
libration	लिब्रेशन
leaderon	लीडेरों
leedaron	लीड़रों
lidaron	लिड़रों
liidaron	लिड़िरों
louis	लुइस
luis	लुज
ludhakate	लुढ़कते
ludhkate	लुढ़कते
lurhakate	लुरहकते
lutf	लुटफ
lumding	लूमिडिंग
lootmaar	लूटमर
lootmar	लूटरम
landal	लंडल
lendal	लेंडल
lega	लेगा
legaa	लेगा
letakar	लेटाकर
letkar	लेटकर
lenevali	लीलेवाली
lenewali	लीलेवाली
label	लबेल
labeling	लेबिंग
labelling	लेबलिंग
labelo	लाबेलो
labelon	लबेलन
lebalon	लेबलों
lemon	लीमों
laingadan	लांगदन
langdon	लंगदों
lengdan	लिंगनड
laigikata	लालिचाता
laingikta	लांगिकता
lanset	लांसेट
lenset	लेंसेट
lairi	लारी
lairy	लायरी
larry	लारी
lace	लेस
less	लेस
locket	लकेट
laundry	लाउंद्री
longewal	लागेंवल
longewala	लंगेवाला
longoval	लोगंवोल
log	लोग
loge	लोगे
lochdar	लोचड़र
lodi	लोड़ी
laurence	लारेंस
laurens	लारेंस
laurense	लारेंस
wonder	यूनेडर
vansh	फांश
vanshdhar	फनशाधर
vanshavad	फनशावड़
vanshvaad	फांशवाद
vanshvad	फांशवाद
wanshwad	णानशवाद
vajood	बाजूद
vajud	बाजूद
wajood	बाजूद
vadali	बादाली
vadli	बादली
wadali	डादली
vanita	बनीता
vareinye	फेरेनी
varenya	बरेन्या
varn	फरन
varna	फरना
varnit	फार्निट
vartamaan	फर्तमान
vartaman	फर्तमन
vartmaan	फर्तमान
vartman	फर्तमन
varddhaman	फर्द्धाना
vardhmaan	फर्धमान
vardhman	फर्धमन
verbal	फेरबाल
varshan	फर्शन
vasharan	फ़शरन
vershan	फेरशन
version	फेर्शन
varsaache	फरसेचे
varsaryache	फरसरिचय
vasearche	फासर्डेल
valkan	बालकन
valkkan	बालकण
velkan	फेलकन
vash	फाश
vashikaran	फशीकरण
vaangchuk	फांगुखुक
vangchuk	फंगुचक
wangchuk	फंगुक्छ
want	यंट
vije	फिजे
vise	फाइस
wise	फाइज
vatar	फटर
water	फेटर
watson	टटसन
wattson	टट्सन
vaan	बान
waan	यान
vaanon	फानों
vanon	फानों
wanon	यौनों
vatanukulan	फटूंकुराओं
watanukoollan	तटुंकुलीतार
vaadak	बादक
vadak	बदक
vaadiyon	बादियों
vadiyon	बादियों
wadiyon	डादियों
vayana	बायना
vayna	बायना
wayna	यावना
wireless	येरेल्स
wirerless	रियरलेस
warrior	यार्रियर
warriors	याररिस
valve	बलवे
wolv	फॉल
vastavik	फस्तवाकि
vastvik	फस्तविक
vaahikayen	बाइखेयन
vahikayen	बहिकाएं
wahikayan	बहिकायान
winter	इंटर
vincent	फिंटेंस
vikalpon	फीकलपों
wicket	यिक्टेक
vikramjeet	फिक्रमीजत
vikramjit	फिक्रमिज्त
vichaarakon	फिचारकों
vicharakon	फिचराकों
vigyan	बिग्यन
vigyaani	बिग्यानी
vigyani	बिग्यानी
vigyaanon	बिग्यानों
vigyanon	बिग्यनों
vitthal	फिटवाल
viththal	फिठताल
vitthal	फिटवाल
vitark	फितर्क
vidhaaein	फिधाईं
vidyaayein	फिड़ायाएं
vidyaen	फिद्याने
vidhaaon	फिधानों
vidyaaon	बिद्याहन
vidyaon	फिद्यान
vidhansabhaein	फिधनशीनाह
vidhansabhaen	फिधनशाहन
vidhivat	फिधिवात
vidhut	फिधूत
vinasht	फीनाष्ट
vineet	फिनिट
vinit	फिनित
vipreetataa	फिप्रीतिता
vipritata	फिप्रितिता
vipra	फिप्रा
vipro	फिप्रो
wipro	यिप्रो
vibha	फिभा
vibhajak	फिभंजक
vibhram	फिभ्रम
vibhrm	फिभ्रम
vibram	फिब्रम
vimarsh	फिमर्श
vimarsho	फिमर्षो
vimarshon	फिमर्शों
virajati	फिराजाती
virechan	फरीशन
virodh	फिरोध
virodhabhasi	फिरोधाशी
virodhabhason	फिरोधिबास
vividh	फिविध
vivekahin	फीवेखियां
vivekheen	फीविचीन
visheshan	फीशेशन
visheshanon	फीशेशनों
visheshaadhikaar	फिशेशाधिकार
visheshadhikar	फिशेशाधिकर
vishwasaniy	फीश्वनीय
vishwasniiya	फीश्वनिषीय
vishwasaniyata	फीश्वनिशातिया
vishwasniiyataa	फीश्वनियातिका
vishahin	फ़िशाहीं
vishhin	फीशीन
vishanu	फीशनू
vishnu	फिश्नु
vlc	एलपीसी
weeks	यिक्स
veerchand	फर्चंद
virchand	फर्चंद
veeresh	फीरेश
viresh	फीरश
vritton	फ्रीटन
vruton	क्यूटोन
vrutton	क्टूटों
venkataraman	बेंकतरमान
venkatraman	फेंकतरमान
ved	बेड
wade	यडे
wed	येड
wedding	येडिंग
vediyon	बेड़ियों
vedon	बेड़ों
venezuela	बेजेनेहला
veronica	फेरोनिका
veronika	फेरोनिका
weronika	फेरोनिका
velvet	बेलवेट
welwet	फेलवेट
welder	फेल्डर
weldor	फेल्डर
welding	फेल्डिंग
wealth	येथल
vellur	फेलर
velur	फेलर
vesh	फेश
wasting	यस्टिंग
westing	फेस्टिंग
wastinghouse	यस्तांचिसु
westinghouse	फेशनाशियट
vaisley	फैसले
vesle	बेसल
wesle	फेसल
vaigyaanik	बायिग्ञानिक
vaigyanik	बायग्ञानिक
vegyanik	बेग्यनिक
vaigyaanikta	बायिग्ञानता
vaigyanikata	बायिग्ञानता
vaigyanikta	बाजियंगिता
vaitravati	फैत्रवाती
vaitrawati	फैत्रवाती
vaimanasy	फैमानासी
vaimanasya	फैमानस्य
vaimanya	बायमान्य
very	बेरी
vaisaakh	बैशाक
vaishakh	फैशाख
vaishaakhi	फैशाखी
vaishakhi	फैशाखी
vaishnodevi	फैशनादेव
vyaktigat	व्याक्तिगत
vyagr	फ्यागर
vyagra	ब्याग्र
vyatit	ब्वातित
vytit	य्विट
vyabhichar	फ्याभिचर
vyabhichari	फ्याभोषी
vyavadhan	व्यावधान
vyavdhan	व्यावधान
vyavahargat	फ्यावघर
vyvhargat	फ्यवाग्रत
vyaghat	फ्याघत
vyapak	व्यापक
vlad	फ्लैड
wlaad	ल्लाड
vladimir	फ्लादिमिर
shanghai	क्षणाही
shatpath	क्षत्पत
shanivar	क्षीणवार
shaniwar	क्षीणवार
shabana	क्भाना
shbana	क्भाड़ा
shabdarth	क्षबाध्रत
shamadan	क्षमदान
shmadan	क्षमदान
shamitabh	क्षमित्भ
shamil	क्षमिल
shmil	क्षमिल
sharabon	क्षारबों
shrabon	क्षबारों
shararat	क्षरारत
shrart	कृष्टर
sharmana	क्षमराना
shaharwasiyon	क्षाहर्वेशियों
shahrvasiyon	क्षावर्तियों
shervasiyon	क्रेवस्विनों
shahdara	क्षहादारा
shaantikaal	क्षांतिकाल
shantikal	क्षांतिकल
shaao	क्षाहों
shao	क्षाओ
shaakir	क्षाइकर
shakir	क्षाकिर
shaakhaaen	क्षाहाकी
shakhayan	क्षाखायन
shakhayen	क्षाखाएं
shayak	क्षायक
shaavakon	ख्शावकों
shavakon	क्षावकों
shavkon	ख्वाकों
shaasaka	क्षाकासा
shasak	क्षाक
sasakon	कसकों
shaasakon	क्षाककों
shasakon	क्षाककों
shipra	क्षीप्र
shirke	किषिका
sheershakon	क्षीर्कशों
shirshakon	क्षीरक्षाओं
shirshkon	क्षिरक्षों
shujaat	ख्यूदित
shujat	ख्यूद्ति
shooting	क्षोटिंग
shutting	क्षत्तिगं
should	क्योडल्ड
shud	क्षुड
shubhankar	क्षुनाबकर
shumaali	क्षूमली
shumali	क्षमुली
shringaar	कृषंगार
shringar	क्रिषेंगर
shrungar	कृषंगर
sheling	क्वेलिंग
shelling	क्छेलिंग
shaili	क्षैली
shaly	क्षली
sheli	क्षेली
shaishav	क्षीवश
sean	एसीन
shaun	क्षौं
shawn	क्षावन
short	क्रोडर
sure	न्सूर
shrankhala	क्ष्णकाला
shrankhalaa	क्ष्णकाला
shrunkhla	कृष्लुखा
shrankhalaaon	क्ष्णाकालाहों
shrinkhalaon	क्षिन्लकशाओं
shrunkhlaon	कृष्लकाहन
shravani	क्षरवानी
shrikar	क्षिरकर
shrikhand	क्षिर्धकंद
shrimati	कृष्मति
shriram	कृष्रम
sriram	कृरम
shrotaon	कृष्टान
shat	क्षत
sankhyaein	कंशकियां
sankhyaen	कंशकाएं
sankhyayen	कनकाशयन
sanghanit	कंगानित
sanghnit	कंग्नित
sanchayan	ननचायान
sanchar	कनचर
sanchaari	कनचारी
sanchari	कनचारी
sanchalanon	नंचलानों
sanchalnon	नंचलनों
sanjay	कंजे
sanjeevan	कसंबिवां
sanjivan	कसंबिवां
santati	कनत्ति
sandarbh	कंदंबर्ह
sandarbha	कंदंबाढ़
sandrbh	कंदर्भ
sandarbhon	कंदंबोष
sandrbhon	कंदर्भों
sandali	कंदाली
sandli	एसंडली
sandhan	कंधन
samprati	कम्परत्पी
samprti	एसम्परी
samprabhu	कम्परंभु
samprbhu	कम्पर्शु
samprabhuta	एस्मरपभूता
samprbhuta	कम्पर्शुपता
sambit	कंबित
sambhalane	नमभालने
sambhalne	नमभेलने
sambhrant	कमभंर्ट
sanbharnt	ननभारंत
sanyog	कनायोग
sanyukt	कन्युक्त
sanyukta	कन्युक्षता
sanyukta	कन्युक्षता
sanyogvash	क्नीयार्खि
sanyojan	कन्यादोन
sanyojanon	कनायजोनों
sanyojnon	कनायजों
samvedikaran	कमेदेविकरण
sanvedikaran	कनेद्वेकरण
samshayon	कमशायों
sanshayon	कनशायों
sanshyon	कनश्यों
sanskaar	कसंसकार
sanskar	कससंकर
sanskaari	कसंसकारी
sanskari	कसस्तारिया
sanskrit	कससंक्रित
sanskurt	कनस्कर्ट
sanskritiyan	कसस्त्यनिकी
sanskrutiyan	संस्कृत्यन
sanskritiyon	कसंस्करियों
sanskrutiyon	कसंस्कृतिया
sanasthit	ननस्थित
sansthit	कसंतिह
sanasthita	ननस्थिता
sansthita	कसंस्थिता
sakara	कसाकार
sakra	कस्कार
sakshan	कक्षण
suction	क्सूटियन
sacchidanand	एच्चीडेंडन
sachhidanand	चचीदाधन
sachidanand	कचीदंदें
sajja	कसजा
sat	एस्ट
satpal	कत्पाल
satluj	कत्रुज
sataane	कताने
satane	कतने
sate	एस्ट
satti	कट्टी
satvat	कत्वात
sadanand	कदानंद
sapane	एसापें
sapne	एसने
sapney	एसने
saparivaar	एस्पेरिवार
sapariwar	एस्परेवर
sparivar	एस्पीरवार
sapaat	एसापाट
sapat	क्पात
sapate	एसपेट
sapatey	क्पेते
saptakranti	क्पत्यसत्न
saptkraanti	क्पत्रकत्नि
saptapadi	क्पतपदाई
saptpadi	क्पप्तादिम
saptari	क्पत्रायों
sapramaan	एस्परामन
sapraman	एस्परमन
submit	ड्सुबिमित
sabmission	कमसिशन
submission	न्सुबिसिन
sabhaein	क्भाएं
sabhaen	क्भाएं
sabhayen	क्भायें
sabhen	एशेन
sabhasadon	कशादों
sabhyata	क्यभत्या
samjhoonga	कमंभिगत
samjhunga	कम्जांचाओं
samjhungaa	कमंजीगा
saman	एसमान
samanvayaka	कमानवायका
samanwayaka	कमानवायका
samnvyak	कमन्वैक्ष
samaadhaan	नमाधान
samadhan	एमाधन
samadhiyon	कमाधियों
samadjiyon	कमदाजियों
samalakha	कमालक्छ
samalakhaa	एमाकला
samahaar	कमाहार
samahar	कमाहर
samitiyan	कमीतियां
sametati	नमेटटी
sametti	कमेट्टी
sarka	करका
sarkaa	करका
sarkarein	करसागें
sarkaren	करसागाने
sarkaaron	करसाकारों
sarkaron	करसाकरों
sargana	करागना
sarganaon	करदालानों
sargi	कर्गी
sarguja	करदुगा
sarjuga	करसुगा
sarsa	कसरा
sarsaa	कसरा
sarahind	नरहाशिड
sarhind	करहिंद
sirhind	इिरिशंड
saraaha	क्राशा
saraha	क्राहा
saraahi	क्राशाई
sarahi	क्राशी
salaahkar	क्लाधाकार
salahkaar	क्लाधाकार
salahkar	क्लाधाकार
saleeb	क्लीब
salib	क्लीब
select	नेकाल्ट्ट
saltanat	क्लेंटात
saltnat	क्लॉटन्ट
savaal	एवासल
saval	एजाल
sawaal	एवांक
sawal	एवाल
sahakalaakar	क्हातकागाकर
sahakalakar	क्हातकाकारक
sahkalakar	क्हातकागकर
sahadev	कहदेव
sahdev	एदहेद
sahrawat	क्हरवात
sherawat	क्षैरवल
sahooliyata	क्होउमिलता
sahuliyat	कहोनियतिल
sahuuliyata	कहोउमिकातिया
saanketika	कनेसेकिता
sanketik	कनेक्टिक
saimans	एमैंस
simmons	नाइममंस
symons	एम्संम
saima	नैमा
sagarika	करेगिका
sagrika	कर्गिका
saga	क्गा
saajan	कसान
sajan	कजान
saajsajja	क्मजज्ज
sajsajja	कजस्जाज
saja	कजा
saathsaath	कसहात्ष
sathsath	कत्सशत
sathiya	कथिया
saabah	कमाह
sabah	कबाह
samanjasy	कमानज्री
samanjasya	कमानज्ञास
samoa	कमो
samoaa	कमोडा
saayn	कसाई
sayan	क्यान
saym	कमी
saira	न्सैरा
sayara	कमरा
sayra	केयरा
salve	एल्सवे
sahab	कहाब
singapore	निनोजेस्लायर
singaar	निशंग
singar	निशंग
singer	निजेंसर
singhaadey	निशंगाजे
singhade	निशंगेड़
singhde	निशंदेगे
singhre	निशंगे
singhi	एसंगी
singha	निंशा
sinha	एसिना
siera	नीसार
sierra	कीरेरा
sikud	निकीद
signals	किंगिर्क
cigaretton	किगर्टेनों
cigretton	किग्रेटन
siddhivat	किदिधिवत
siddhvat	निद्धिवत
siddhwat	निद्धिवत
sinabang	एसिनबंग
synapse	एजनाइस्टी
sipah	एसआपिएफ
sipaha	निपाशा
sipahiyon	निपाशियों
sipahi	निपाशी
sim	एमएएमआई
simat	एमिमैट
simatataa	किमातता
simatta	नीमाटता
simtata	निमटैटा
simtataa	किमताता
cement	केमेंट
simate	निमेट
simi	एमआईएमए
simmy	एमएमएमी
sims	एमिएस
siyasi	नियासी
siyah	नियाह
siyaha	क्याइहा
sirpur	एर्शपर
sivan	एसीवन
siwan	इ्वीना
sisva	न्सिवा
siswa	एसिसवा
cil	कील
csi	डिसी
sikar	निकीर
seaten	एस्येटन
sitaram	एटीसरां
sitaharan	निथासारण
cpm	एपीएम
cps	एसपीएस
cbse	कीएसए
seem	एमिम
sim	एमएएमआई
sealed	एस्लाइड
shield	क्याइट्ज
ccd	कीडीडी
sugamata	नृदाता
sugmta	डृदमता
sujan	नुजान
sujen	कुजें
suken	क्कूएं
sujain	क्वाएस
sujhaati	कुझाति
sujhati	कुझती
sutali	ऋटली
sutli	ऋत्ली
suta	न्तूड़ा
sdueep	एस्टी
sudip	न्दुडिप
sudhaargrah	क्षुध्रग्र
sudhargrih	क्षुध्रगृग
sudhargruh	क्षुध्रग्रह
sunaaron	न्सौनों
sunaron	न्सौरों
sunaseer	न्सुनिस
sunasir	न्सुनिस
suneeti	न्सुनिति
suniti	न्सुनिति
sunega	नुनेगा
suneyga	न्सेएंगा
superhit	न्पूरेहित
supachy	न्पूचेय
supachya	न्पूचाय
supachye	न्पूचेय
subhaay	क्भौय
subhay	क्भुय
surveen	ऩुर्वीन
survin	ऩुर्विन
surana	ुसराना
sulkhan	नक्लचन
suljaayi	नुलकाएबी
suljayi	नुलकामी
suljhai	कुलाखाएं
sulzai	नुलकाई
sultana	न्लुतना
sulaati	क्लौति
sulati	न्कूलती
susanskrit	सुसंस्कृत
susanskrut	सुसंस्कृत
suhagin	न्हादिगीन
soond	नस्ड
sund	नड
suiyan	क्षियां
sukhati	क्कुति
sukhti	क्कुति
sukhakar	कक्काकर
soochak	नूचक
suchak	एशकुच
sooja	कौजा
suja	न्वूजा
suba	स्बूबा
sube	एसब
sooraj	नुसाज
suraj	नुसाब
surinaam	न्रुनिमान
surinama	नुरीनमा
suriname	न्रुनिमैन
suryadev	सुर्यावेद
sendha	एंडेशा
senvai	एसेनावी
sevai	न्वेवी
sensing	एसेंसिंग
sexual	एजसेकल
saturday	कत्रदाय
seti	नेटी
seto	नेटो
seth	ईच
safety	एफ्टेडी
semen	एमेन
semin	नेमिन
self	एल्सफ
selfie	एल्सफी
save	एवे
sev	एसवी
sevakon	नेवकों
sevkon	नेक्वों
samuels	एम्यूजल्स
celery	केलरी
salary	क्रेलाय
sakar	कसाकर
socar	क्साकर
soccer	कॉस्कर
songs	नॉज्स
solicitor	कोरिकिशल
sochane	कोशेन
sochne	कोशने
sonu	क्सों
soma	कमा
spma	एसपीएमा
somi	कमी
soy	एसए
soya	क्योया
solitaire	नोलिटेशन
soharai	कोहासारी
sohrai	न्षोराई
sohaval	नोहोवाल
sohawal	नोहॉवाल
saunpane	नौनपेने
sonpne	नन्सेने
scala	एस्काला
skala	क्कैला
ski	एसकी
scootaron	एस्टूर्नों
scooteron	एस्टूर्न
skootaron	क्रोटकरों
scandinavia	एस्टिंडिजेन
scaining	एस्टाइनिंग
scanning	एसिंगिंग
squash	क्काश
squash	क्काश
skhalan	क्चलान
stain	एस्टेन
stan	एसटन
stop	एसटेपी
stops	एस्टॉप्स
stone	एस्टन
straws	एस्ट्रव्स
stress	एस्ट्रेस
stra	एस्ट्रा
stray	एस्टरी
stre	एसटीएर
strocks	एर्ट्संक
strokes	एर्ट्सोज
stan	एसटन
stanadhari	एटनाशदरी
standhaari	एटनाशदरी
standhari	एटनाशड़ी
sthiti	क्षिटि
stithi	क्षतिति
stuti	क्तूति
sthitiyaan	क्षिटियाएं
sthitiyan	क्षिटियानी
sthitiyon	क्षित्तियों
sthool	क्षोत
sthul	क्षतुल
sthoolta	क्चोथल
sthulata	दृथलता
sneakers	न्निएस्कर्स
snickers	न्निस्केसर
snikarse	न्निक्सर
spear	एस्पर
spell	एसपेल
spelar	एस्पेलर
speller	एस्लेलर
sprint	एस्रेपेंट
sprit	एस्रपिट
spray	एस्रेप
spry	एसएरपी
sfoorti	एस्वूर्टी
sfurti	स्रुफ्ती
sphoorti	एश्रूप्टी
slide	एल्साइड
slider	एल्सीडर
slaaidon	एलासेडों
slidon	एल्सीडन
sliders	एल्सीडर्स
slides	एल्सीडेस
slice	एल्सी
slash	एलसाश
swaroopon	ए्सवरोपों
swarupon	ए्वसूरपों
swa	एसवा
swaachaalit	ए्वाशेलिट
swachalit	ए्वाशलिट
swaarthparak	ए्वस्रावप्थ
swarthparak	ए्वार्षापंतुर
swiftlate	ए्व्फिसल्वट
swiftlet	ए्फ्सीवल्ट
sweekarte	न्वीकेरते
swikarte	न्विकेतरे
sweet	एव्वीट
sweep	ए्व्पीप
sweccha	एस्क्छा
swecha	ए्वेशा
swechha	न्वेछाह
sweta	ए्वेटा
swap	ए्वस
swipe	ए्व्सीप
handiya	अध्निया
handiyaa	अध्निया
hundiya	ुूंधिया
hakikat	खखिकत
haqeeqat	चचेकत
hathiya	चठिया
hamala	अममाला
hamla	अमला
hamalavar	अममालाव
hamlavar	अंमलावर
humlavar	आूमलावार
hamaal	अमाल
hamal	अममल
hercules	एेर्कफल्स
hardas	अधरद
harpaal	अर्पाल
harpal	अर्पल
harvansh	भारवंश
haraval	अभरावल
harawal	भारावल
hurricane	ञूर्रेनियन
harijan	भारीजन
hariyali	अभ्रियाली
harshit	अशरित
haldi	थागीडी
halla	थाला
hawamahal	भहमवाल
hawalaat	अभलात
hawalat	अभलत
hasino	झैसिनों
hasinon	झसिनों
haan	भान
han	अान
haanfte	अैंथपेट
hafate	चहते
hanfte	अैंफेट
higman	किग्मान
hymen	बेमेन
hadauti	अधातुई
haani	अहानी
hani	उनी
haarjeet	अार्जीत
harjeet	अर्जीत
haaranaa	भारणा
harana	अधराना
harna	भढ़ना
haalchaal	फाचलाक
haalchal	फाचलाल
halchaal	चच्लाल
halchal	चच्लाल
halt	ठाल्ट
hault	थाल्ट
hahakar	ठहकर
hingis	फिंगस
hindan	अधिनद
hindon	ुधिनों
hijada	बिजाड़ा
hijda	बिज्दा
hijbul	अिजबूल
hippo	झिप्पों
hippopotamus	झिप्पापोस्त
himali	हिमली
hilane	तिलाने
hilne	तिलने
hisham	खिशम
heeraganj	अेरिगांज
hiraganj	उध्रगंज
heroes	इेरोज
heros	इैरोस
hui	ुभी
huin	झूइन
hooper	ँपूर
huppar	ँपपर
hupper	ँपपर
hegde	बेग्दे
hemvati	बेमवती
hemwati	बेमवती
help	एचपी
helper	एंप्लर
haito	ऑैटो
hairam	अहर्म
harem	अड़ेम
herald	अेर्लैड
haive	अह्वे
have	अभवे
hong	ऑंग
half	चाफ
hoaf	ऑफ
hounga	ऊंगा
holding	काल्डिंग
hoshangabaad	ओषणबाघांज
hoshangabad	ओषणगाबाद
hostes	ऑस्टेस
hostess	ऑस्टेस्स
